regiao;estado;data;casosNovos;casosacumulados;obitosNovos;obitosacumulados
Centro-Oeste;DF;2020-03-07;0;1;0;0
Centro-Oeste;DF;2020-03-08;0;1;0;0
Centro-Oeste;DF;2020-03-09;0;1;0;0
Centro-Oeste;DF;2020-03-10;0;1;0;0
Centro-Oeste;DF;2020-03-11;1;2;0;0
Centro-Oeste;DF;2020-03-12;0;2;0;0
Centro-Oeste;DF;2020-03-13;0;2;0;0
Centro-Oeste;DF;2020-03-14;6;8;0;0
Centro-Oeste;DF;2020-03-15;6;14;0;0
Centro-Oeste;DF;2020-03-16;5;19;0;0
Centro-Oeste;DF;2020-03-18;15;34;0;0
Centro-Oeste;DF;2020-03-19;8;42;0;0
Centro-Oeste;DF;2020-03-20;45;87;0;0
Centro-Oeste;DF;2020-03-21;21;108;0;0
Centro-Oeste;DF;2020-03-22;9;117;0;0
Centro-Oeste;DF;2020-03-23;21;138;0;0
Centro-Oeste;DF;2020-03-24;23;161;0;0
Centro-Oeste;DF;2020-03-25;34;195;0;0
Centro-Oeste;DF;2020-03-26;6;201;0;0
Centro-Oeste;DF;2020-03-27;40;241;0;0
Centro-Oeste;DF;2020-03-28;19;260;0;0
Centro-Oeste;DF;2020-03-29;38;298;1;1
Centro-Oeste;DF;2020-03-30;14;312;1;2
Centro-Oeste;DF;2020-03-31;21;333;1;3
Centro-Oeste;DF;2020-04-01;37;370;1;4
Centro-Oeste;DF;2020-04-02;30;400;1;5
Centro-Oeste;DF;2020-04-03;19;419;1;6
Centro-Oeste;DF;2020-04-04;37;456;1;7
Centro-Oeste;DF;2020-04-05;12;468;0;7
Centro-Oeste;DF;2020-04-06;17;485;3;10
Centro-Oeste;DF;2020-04-07;18;503;2;12
Centro-Oeste;DF;2020-04-08;6;509;0;12
Centro-Oeste;DF;2020-04-09;18;527;1;13
Centro-Oeste;DF;2020-04-10;29;556;1;14
Centro-Oeste;DF;2020-04-11;36;592;0;14
Centro-Oeste;DF;2020-04-12;26;618;0;14
Centro-Oeste;DF;2020-04-13;23;641;1;15
Centro-Oeste;DF;2020-04-14;10;651;2;17
Centro-Oeste;DF;2020-04-15;37;688;0;17
Centro-Oeste;DF;2020-04-16;39;727;3;20
Centro-Oeste;DF;2020-04-17;29;756;4;24
Centro-Oeste;DF;2020-04-18;40;796;0;24
Centro-Oeste;DF;2020-04-19;64;860;0;24
Centro-Oeste;DF;2020-04-20;15;875;0;24
Centro-Oeste;DF;2020-04-21;38;913;0;24
Centro-Oeste;DF;2020-04-22;46;959;1;25
Centro-Oeste;DF;2020-04-23;9;968;1;26
Centro-Oeste;DF;2020-04-24;44;1012;0;26
Centro-Oeste;DF;2020-04-25;8;1020;1;27
Centro-Oeste;DF;2020-04-26;105;1125;0;27
Centro-Oeste;DF;2020-04-27;64;1189;1;28
Centro-Oeste;DF;2020-04-28;41;1230;0;28
Centro-Oeste;DF;2020-04-29;83;1313;0;28
Centro-Oeste;DF;2020-04-30;110;1423;2;30
Centro-Oeste;DF;2020-05-01;123;1546;1;31
Centro-Oeste;DF;2020-05-02;59;1605;1;32
Centro-Oeste;DF;2020-05-03;115;1720;1;33
Centro-Oeste;DF;2020-05-04;73;1793;0;33
Centro-Oeste;DF;2020-05-05;44;1837;1;34
Centro-Oeste;DF;2020-05-06;209;2046;1;35
Centro-Oeste;DF;2020-05-07;212;2258;0;35
Centro-Oeste;DF;2020-05-08;184;2442;2;37
Centro-Oeste;DF;2020-05-09;134;2576;2;39
Centro-Oeste;DF;2020-05-10;106;2682;3;42
Centro-Oeste;DF;2020-05-11;117;2799;2;44
Centro-Oeste;DF;2020-05-12;180;2979;2;46
Centro-Oeste;DF;2020-05-13;213;3192;2;48
Centro-Oeste;DF;2020-05-14;224;3416;3;51
Centro-Oeste;DF;2020-05-15;371;3787;4;55
Centro-Oeste;DF;2020-05-16;353;4140;1;56
Centro-Oeste;DF;2020-05-17;228;4368;2;58
Centro-Oeste;DF;2020-05-18;250;4618;8;66
Centro-Oeste;DF;2020-05-19;235;4853;6;72
Centro-Oeste;DF;2020-05-20;418;5271;6;78
Centro-Oeste;DF;2020-05-21;271;5542;6;84
Centro-Oeste;DF;2020-05-22;406;5948;6;90
Centro-Oeste;DF;2020-05-23;300;6248;5;95
Centro-Oeste;DF;2020-05-24;390;6638;9;104
Centro-Oeste;DF;2020-05-25;292;6930;10;114
Centro-Oeste;DF;2020-05-26;280;7210;10;124
Centro-Oeste;DF;2020-05-27;551;7761;9;133
Centro-Oeste;DF;2020-05-28;539;8300;9;142
Centro-Oeste;DF;2020-05-29;422;8722;12;154
Centro-Oeste;DF;2020-05-30;752;9474;8;162
Centro-Oeste;DF;2020-05-31;306;9780;8;170
Centro-Oeste;DF;2020-06-01;730;10510;3;173
Centro-Oeste;DF;2020-06-02;746;11256;4;177
Centro-Oeste;DF;2020-06-03;764;12020;14;191
Centro-Oeste;DF;2020-06-04;903;12923;5;196
Centro-Oeste;DF;2020-06-05;1285;14208;6;202
Centro-Oeste;DF;2020-06-06;1642;15850;6;208
Centro-Oeste;DF;2020-06-07;773;16623;6;214
Centro-Oeste;GO;2020-03-12;0;3;0;0
Centro-Oeste;GO;2020-03-13;0;3;0;0
Centro-Oeste;GO;2020-03-14;1;4;0;0
Centro-Oeste;GO;2020-03-15;0;4;0;0
Centro-Oeste;GO;2020-03-16;5;9;0;0
Centro-Oeste;GO;2020-03-17;1;10;0;0
Centro-Oeste;GO;2020-03-18;2;12;0;0
Centro-Oeste;GO;2020-03-19;3;15;0;0
Centro-Oeste;GO;2020-03-20;3;18;0;0
Centro-Oeste;GO;2020-03-21;1;19;0;0
Centro-Oeste;GO;2020-03-22;2;21;0;0
Centro-Oeste;GO;2020-03-23;2;23;0;0
Centro-Oeste;GO;2020-03-24;6;29;0;0
Centro-Oeste;GO;2020-03-25;6;35;0;0
Centro-Oeste;GO;2020-03-26;3;38;1;1
Centro-Oeste;GO;2020-03-27;11;49;0;1
Centro-Oeste;GO;2020-03-28;7;56;0;1
Centro-Oeste;GO;2020-03-29;0;56;0;1
Centro-Oeste;GO;2020-03-30;4;60;0;1
Centro-Oeste;GO;2020-03-31;5;65;0;1
Centro-Oeste;GO;2020-04-01;8;73;0;1
Centro-Oeste;GO;2020-04-02;0;73;0;1
Centro-Oeste;GO;2020-04-03;15;88;1;2
Centro-Oeste;GO;2020-04-04;15;103;0;2
Centro-Oeste;GO;2020-04-05;12;115;1;3
Centro-Oeste;GO;2020-04-06;4;119;2;5
Centro-Oeste;GO;2020-04-07;14;133;0;5
Centro-Oeste;GO;2020-04-08;26;159;2;7
Centro-Oeste;GO;2020-04-09;20;179;0;7
Centro-Oeste;GO;2020-04-10;12;191;1;8
Centro-Oeste;GO;2020-04-11;18;209;2;10
Centro-Oeste;GO;2020-04-12;20;229;4;14
Centro-Oeste;GO;2020-04-13;4;233;1;15
Centro-Oeste;GO;2020-04-14;51;284;0;15
Centro-Oeste;GO;2020-04-15;20;304;0;15
Centro-Oeste;GO;2020-04-16;14;318;1;16
Centro-Oeste;GO;2020-04-17;17;335;0;16
Centro-Oeste;GO;2020-04-18;43;378;2;18
Centro-Oeste;GO;2020-04-19;15;393;0;18
Centro-Oeste;GO;2020-04-20;10;403;1;19
Centro-Oeste;GO;2020-04-21;18;421;0;19
Centro-Oeste;GO;2020-04-22;17;438;2;21
Centro-Oeste;GO;2020-04-23;15;453;2;23
Centro-Oeste;GO;2020-04-24;33;486;1;24
Centro-Oeste;GO;2020-04-25;20;506;1;25
Centro-Oeste;GO;2020-04-26;67;573;0;25
Centro-Oeste;GO;2020-04-27;43;616;1;26
Centro-Oeste;GO;2020-04-28;45;661;1;27
Centro-Oeste;GO;2020-04-29;44;705;0;27
Centro-Oeste;GO;2020-04-30;76;781;2;29
Centro-Oeste;GO;2020-05-01;27;808;0;29
Centro-Oeste;GO;2020-05-02;17;825;1;30
Centro-Oeste;GO;2020-05-03;25;850;0;30
Centro-Oeste;GO;2020-05-04;11;861;0;30
Centro-Oeste;GO;2020-05-05;61;922;8;38
Centro-Oeste;GO;2020-05-06;102;1024;7;45
Centro-Oeste;GO;2020-05-07;3;1027;-1;44
Centro-Oeste;GO;2020-05-08;26;1053;5;49
Centro-Oeste;GO;2020-05-09;16;1069;-2;47
Centro-Oeste;GO;2020-05-10;24;1093;0;47
Centro-Oeste;GO;2020-05-11;7;1100;2;49
Centro-Oeste;GO;2020-05-12;15;1115;3;52
Centro-Oeste;GO;2020-05-13;110;1225;9;61
Centro-Oeste;GO;2020-05-14;235;1460;6;67
Centro-Oeste;GO;2020-05-15;145;1605;0;67
Centro-Oeste;GO;2020-05-16;47;1652;2;69
Centro-Oeste;GO;2020-05-17;40;1692;1;70
Centro-Oeste;GO;2020-05-18;89;1781;3;73
Centro-Oeste;GO;2020-05-19;99;1880;0;73
Centro-Oeste;GO;2020-05-20;169;2049;5;78
Centro-Oeste;GO;2020-05-21;106;2155;7;85
Centro-Oeste;GO;2020-05-22;189;2344;10;95
Centro-Oeste;GO;2020-05-23;91;2435;0;95
Centro-Oeste;GO;2020-05-24;53;2488;0;95
Centro-Oeste;GO;2020-05-25;27;2515;1;96
Centro-Oeste;GO;2020-05-26;191;2706;8;104
Centro-Oeste;GO;2020-05-27;200;2906;4;108
Centro-Oeste;GO;2020-05-28;195;3101;7;115
Centro-Oeste;GO;2020-05-29;420;3521;4;119
Centro-Oeste;GO;2020-05-30;88;3609;5;124
Centro-Oeste;GO;2020-05-31;117;3726;0;124
Centro-Oeste;GO;2020-06-01;291;4017;3;127
Centro-Oeste;GO;2020-06-02;469;4486;28;155
Centro-Oeste;GO;2020-06-03;215;4701;4;159
Centro-Oeste;GO;2020-06-04;401;5102;5;164
Centro-Oeste;GO;2020-06-05;503;5605;3;167
Centro-Oeste;GO;2020-06-06;165;5770;5;172
Centro-Oeste;GO;2020-06-07;87;5857;1;173
Centro-Oeste;MS;2020-03-14;0;2;0;0
Centro-Oeste;MS;2020-03-15;0;2;0;0
Centro-Oeste;MS;2020-03-16;2;4;0;0
Centro-Oeste;MS;2020-03-17;2;6;0;0
Centro-Oeste;MS;2020-03-18;1;7;0;0
Centro-Oeste;MS;2020-03-19;2;9;0;0
Centro-Oeste;MS;2020-03-20;3;12;0;0
Centro-Oeste;MS;2020-03-21;4;16;0;0
Centro-Oeste;MS;2020-03-22;5;21;0;0
Centro-Oeste;MS;2020-03-23;0;21;0;0
Centro-Oeste;MS;2020-03-24;3;24;0;0
Centro-Oeste;MS;2020-03-25;0;24;0;0
Centro-Oeste;MS;2020-03-26;1;25;0;0
Centro-Oeste;MS;2020-03-27;3;28;0;0
Centro-Oeste;MS;2020-03-28;3;31;0;0
Centro-Oeste;MS;2020-03-29;5;36;0;0
Centro-Oeste;MS;2020-03-30;8;44;0;0
Centro-Oeste;MS;2020-03-31;4;48;1;1
Centro-Oeste;MS;2020-04-01;3;51;0;1
Centro-Oeste;MS;2020-04-02;2;53;0;1
Centro-Oeste;MS;2020-04-03;7;60;0;1
Centro-Oeste;MS;2020-04-04;2;62;0;1
Centro-Oeste;MS;2020-04-05;3;65;0;1
Centro-Oeste;MS;2020-04-06;1;66;0;1
Centro-Oeste;MS;2020-04-07;14;80;1;2
Centro-Oeste;MS;2020-04-08;5;85;0;2
Centro-Oeste;MS;2020-04-09;4;89;0;2
Centro-Oeste;MS;2020-04-10;8;97;0;2
Centro-Oeste;MS;2020-04-11;3;100;0;2
Centro-Oeste;MS;2020-04-12;1;101;0;2
Centro-Oeste;MS;2020-04-13;12;113;2;4
Centro-Oeste;MS;2020-04-14;2;115;0;4
Centro-Oeste;MS;2020-04-15;6;121;0;4
Centro-Oeste;MS;2020-04-16;10;131;1;5
Centro-Oeste;MS;2020-04-17;12;143;0;5
Centro-Oeste;MS;2020-04-18;18;161;0;5
Centro-Oeste;MS;2020-04-19;7;168;0;5
Centro-Oeste;MS;2020-04-20;3;171;0;5
Centro-Oeste;MS;2020-04-21;2;173;1;6
Centro-Oeste;MS;2020-04-22;2;175;0;6
Centro-Oeste;MS;2020-04-23;11;186;1;7
Centro-Oeste;MS;2020-04-24;27;213;0;7
Centro-Oeste;MS;2020-04-25;4;217;0;7
Centro-Oeste;MS;2020-04-26;17;234;0;7
Centro-Oeste;MS;2020-04-27;4;238;2;9
Centro-Oeste;MS;2020-04-28;2;240;0;9
Centro-Oeste;MS;2020-04-29;9;249;0;9
Centro-Oeste;MS;2020-04-30;6;255;0;9
Centro-Oeste;MS;2020-05-01;6;261;0;9
Centro-Oeste;MS;2020-05-02;5;266;0;9
Centro-Oeste;MS;2020-05-03;6;272;1;10
Centro-Oeste;MS;2020-05-04;2;274;0;10
Centro-Oeste;MS;2020-05-05;9;283;0;10
Centro-Oeste;MS;2020-05-06;5;288;0;10
Centro-Oeste;MS;2020-05-07;23;311;0;10
Centro-Oeste;MS;2020-05-08;15;326;1;11
Centro-Oeste;MS;2020-05-09;20;346;0;11
Centro-Oeste;MS;2020-05-10;16;362;0;11
Centro-Oeste;MS;2020-05-11;23;385;0;11
Centro-Oeste;MS;2020-05-12;20;405;1;12
Centro-Oeste;MS;2020-05-13;25;430;1;13
Centro-Oeste;MS;2020-05-14;22;452;1;14
Centro-Oeste;MS;2020-05-15;27;479;0;14
Centro-Oeste;MS;2020-05-16;29;508;1;15
Centro-Oeste;MS;2020-05-17;62;570;0;15
Centro-Oeste;MS;2020-05-18;43;613;1;16
Centro-Oeste;MS;2020-05-19;29;642;0;16
Centro-Oeste;MS;2020-05-20;51;693;1;17
Centro-Oeste;MS;2020-05-21;53;746;0;17
Centro-Oeste;MS;2020-05-22;59;805;0;17
Centro-Oeste;MS;2020-05-23;53;858;0;17
Centro-Oeste;MS;2020-05-24;165;1023;0;17
Centro-Oeste;MS;2020-05-25;77;1100;0;17
Centro-Oeste;MS;2020-05-26;86;1186;1;18
Centro-Oeste;MS;2020-05-27;76;1262;0;18
Centro-Oeste;MS;2020-05-28;94;1356;0;18
Centro-Oeste;MS;2020-05-29;62;1418;1;19
Centro-Oeste;MS;2020-05-30;71;1489;1;20
Centro-Oeste;MS;2020-05-31;79;1568;0;20
Centro-Oeste;MS;2020-06-01;78;1646;0;20
Centro-Oeste;MS;2020-06-02;156;1802;0;20
Centro-Oeste;MS;2020-06-03;123;1925;0;20
Centro-Oeste;MS;2020-06-04;72;1997;1;21
Centro-Oeste;MS;2020-06-05;135;2132;0;21
Centro-Oeste;MS;2020-06-06;121;2253;0;21
Centro-Oeste;MT;2020-03-20;0;1;0;0
Centro-Oeste;MT;2020-03-22;1;2;0;0
Centro-Oeste;MT;2020-03-23;4;6;0;0
Centro-Oeste;MT;2020-03-24;1;7;0;0
Centro-Oeste;MT;2020-03-25;2;9;0;0
Centro-Oeste;MT;2020-03-26;2;11;0;0
Centro-Oeste;MT;2020-03-27;0;11;0;0
Centro-Oeste;MT;2020-03-30;7;18;0;0
Centro-Oeste;MT;2020-03-31;7;25;0;0
Centro-Oeste;MT;2020-04-01;3;28;0;0
Centro-Oeste;MT;2020-04-02;13;41;0;0
Centro-Oeste;MT;2020-04-03;3;44;1;1
Centro-Oeste;MT;2020-04-04;16;60;0;1
Centro-Oeste;MT;2020-04-05;0;60;0;1
Centro-Oeste;MT;2020-04-06;16;76;0;1
Centro-Oeste;MT;2020-04-07;2;78;0;1
Centro-Oeste;MT;2020-04-08;12;90;0;1
Centro-Oeste;MT;2020-04-09;18;108;1;2
Centro-Oeste;MT;2020-04-10;4;112;0;2
Centro-Oeste;MT;2020-04-11;9;121;1;3
Centro-Oeste;MT;2020-04-12;2;123;0;3
Centro-Oeste;MT;2020-04-13;11;134;1;4
Centro-Oeste;MT;2020-04-14;4;138;0;4
Centro-Oeste;MT;2020-04-15;13;151;0;4
Centro-Oeste;MT;2020-04-16;5;156;1;5
Centro-Oeste;MT;2020-04-17;6;162;0;5
Centro-Oeste;MT;2020-04-18;9;171;0;5
Centro-Oeste;MT;2020-04-19;3;174;0;5
Centro-Oeste;MT;2020-04-20;7;181;1;6
Centro-Oeste;MT;2020-04-21;0;181;0;6
Centro-Oeste;MT;2020-04-22;24;205;0;6
Centro-Oeste;MT;2020-04-23;15;220;1;7
Centro-Oeste;MT;2020-04-24;21;241;1;8
Centro-Oeste;MT;2020-04-25;5;246;1;9
Centro-Oeste;MT;2020-04-26;3;249;0;9
Centro-Oeste;MT;2020-04-27;7;256;1;10
Centro-Oeste;MT;2020-04-28;7;263;1;11
Centro-Oeste;MT;2020-04-29;29;292;0;11
Centro-Oeste;MT;2020-04-30;10;302;0;11
Centro-Oeste;MT;2020-05-01;18;320;0;11
Centro-Oeste;MT;2020-05-02;13;333;1;12
Centro-Oeste;MT;2020-05-03;4;337;0;12
Centro-Oeste;MT;2020-05-04;7;344;1;13
Centro-Oeste;MT;2020-05-05;22;366;0;13
Centro-Oeste;MT;2020-05-06;19;385;0;13
Centro-Oeste;MT;2020-05-07;34;419;1;14
Centro-Oeste;MT;2020-05-08;45;464;1;15
Centro-Oeste;MT;2020-05-09;38;502;1;16
Centro-Oeste;MT;2020-05-10;17;519;2;18
Centro-Oeste;MT;2020-05-11;26;545;1;19
Centro-Oeste;MT;2020-05-12;59;604;1;20
Centro-Oeste;MT;2020-05-13;69;673;1;21
Centro-Oeste;MT;2020-05-14;61;734;3;24
Centro-Oeste;MT;2020-05-15;58;792;2;26
Centro-Oeste;MT;2020-05-16;65;857;1;27
Centro-Oeste;MT;2020-05-17;44;901;0;27
Centro-Oeste;MT;2020-05-18;40;941;3;30
Centro-Oeste;MT;2020-05-19;64;1005;2;32
Centro-Oeste;MT;2020-05-20;85;1090;0;32
Centro-Oeste;MT;2020-05-21;97;1187;2;34
Centro-Oeste;MT;2020-05-22;84;1271;3;37
Centro-Oeste;MT;2020-05-23;92;1363;0;37
Centro-Oeste;MT;2020-05-24;101;1464;3;40
Centro-Oeste;MT;2020-05-25;130;1594;2;42
Centro-Oeste;MT;2020-05-26;150;1744;1;43
Centro-Oeste;MT;2020-05-27;165;1909;4;47
Centro-Oeste;MT;2020-05-28;176;2085;7;54
Centro-Oeste;MT;2020-05-29;177;2262;3;57
Centro-Oeste;MT;2020-05-30;151;2413;1;58
Centro-Oeste;MT;2020-05-31;72;2485;5;63
Centro-Oeste;MT;2020-06-01;151;2636;4;67
Centro-Oeste;MT;2020-06-02;181;2817;8;75
Centro-Oeste;MT;2020-06-03;212;3029;4;79
Centro-Oeste;MT;2020-06-04;359;3388;5;84
Centro-Oeste;MT;2020-06-05;205;3593;7;91
Centro-Oeste;MT;2020-06-06;195;3788;10;101
Centro-Oeste;MT;2020-06-07;245;4033;12;113
Nordeste;AL;2020-03-08;0;1;0;0
Nordeste;AL;2020-03-09;0;1;0;0
Nordeste;AL;2020-03-10;0;1;0;0
Nordeste;AL;2020-03-12;0;1;0;0
Nordeste;AL;2020-03-13;0;1;0;0
Nordeste;AL;2020-03-16;0;1;0;0
Nordeste;AL;2020-03-17;0;1;0;0
Nordeste;AL;2020-03-18;0;1;0;0
Nordeste;AL;2020-03-19;3;4;0;0
Nordeste;AL;2020-03-20;2;6;0;0
Nordeste;AL;2020-03-21;1;7;0;0
Nordeste;AL;2020-03-22;0;7;0;0
Nordeste;AL;2020-03-23;1;8;0;0
Nordeste;AL;2020-03-24;2;10;0;0
Nordeste;AL;2020-03-25;1;11;0;0
Nordeste;AL;2020-03-26;0;11;0;0
Nordeste;AL;2020-03-27;1;12;0;0
Nordeste;AL;2020-03-28;2;14;0;0
Nordeste;AL;2020-03-29;3;17;0;0
Nordeste;AL;2020-03-30;0;17;0;0
Nordeste;AL;2020-03-31;1;18;1;1
Nordeste;AL;2020-04-01;0;18;0;1
Nordeste;AL;2020-04-02;0;18;0;1
Nordeste;AL;2020-04-03;5;23;1;2
Nordeste;AL;2020-04-04;0;23;0;2
Nordeste;AL;2020-04-05;5;28;0;2
Nordeste;AL;2020-04-06;3;31;0;2
Nordeste;AL;2020-04-07;3;34;0;2
Nordeste;AL;2020-04-08;3;37;1;3
Nordeste;AL;2020-04-09;0;37;0;3
Nordeste;AL;2020-04-10;8;45;0;3
Nordeste;AL;2020-04-11;3;48;0;3
Nordeste;AL;2020-04-12;0;48;0;3
Nordeste;AL;2020-04-13;10;58;1;4
Nordeste;AL;2020-04-14;14;72;0;4
Nordeste;AL;2020-04-15;11;83;1;5
Nordeste;AL;2020-04-16;6;89;0;5
Nordeste;AL;2020-04-17;21;110;2;7
Nordeste;AL;2020-04-18;22;132;3;10
Nordeste;AL;2020-04-19;27;159;5;15
Nordeste;AL;2020-04-20;12;171;3;18
Nordeste;AL;2020-04-21;39;210;1;19
Nordeste;AL;2020-04-22;33;243;1;20
Nordeste;AL;2020-04-23;81;324;2;22
Nordeste;AL;2020-04-24;89;413;5;27
Nordeste;AL;2020-04-25;88;501;2;29
Nordeste;AL;2020-04-26;59;560;3;32
Nordeste;AL;2020-04-27;83;643;2;34
Nordeste;AL;2020-04-28;134;777;2;36
Nordeste;AL;2020-04-29;180;957;5;41
Nordeste;AL;2020-04-30;88;1045;6;47
Nordeste;AL;2020-05-01;181;1226;6;53
Nordeste;AL;2020-05-02;145;1371;5;58
Nordeste;AL;2020-05-03;70;1441;6;64
Nordeste;AL;2020-05-04;97;1538;8;72
Nordeste;AL;2020-05-05;67;1605;8;80
Nordeste;AL;2020-05-06;98;1703;9;89
Nordeste;AL;2020-05-07;164;1867;9;98
Nordeste;AL;2020-05-08;166;2033;10;108
Nordeste;AL;2020-05-09;137;2170;6;114
Nordeste;AL;2020-05-10;88;2258;12;126
Nordeste;AL;2020-05-11;85;2343;12;138
Nordeste;AL;2020-05-12;237;2580;12;150
Nordeste;AL;2020-05-13;181;2761;14;164
Nordeste;AL;2020-05-14;211;2972;13;177
Nordeste;AL;2020-05-15;240;3212;10;187
Nordeste;AL;2020-05-16;381;3593;12;199
Nordeste;AL;2020-05-17;223;3816;11;210
Nordeste;AL;2020-05-18;215;4031;11;221
Nordeste;AL;2020-05-19;288;4319;13;234
Nordeste;AL;2020-05-20;118;4437;17;251
Nordeste;AL;2020-05-21;479;4916;11;262
Nordeste;AL;2020-05-22;386;5302;18;280
Nordeste;AL;2020-05-23;328;5630;21;301
Nordeste;AL;2020-05-24;584;6214;15;316
Nordeste;AL;2020-05-25;468;6682;21;337
Nordeste;AL;2020-05-26;376;7058;15;352
Nordeste;AL;2020-05-27;522;7580;16;368
Nordeste;AL;2020-05-28;476;8056;17;385
Nordeste;AL;2020-05-29;563;8619;21;406
Nordeste;AL;2020-05-30;604;9223;18;424
Nordeste;AL;2020-05-31;1065;10288;19;443
Nordeste;AL;2020-06-01;549;10837;18;461
Nordeste;AL;2020-06-02;722;11559;21;482
Nordeste;AL;2020-06-03;848;12407;24;506
Nordeste;AL;2020-06-04;689;13096;25;531
Nordeste;AL;2020-06-05;843;13939;26;557
Nordeste;AL;2020-06-06;879;14818;25;582
Nordeste;AL;2020-06-07;888;15706;19;601
Nordeste;BA;2020-03-06;0;1;0;0
Nordeste;BA;2020-03-07;1;2;0;0
Nordeste;BA;2020-03-09;0;2;0;0
Nordeste;BA;2020-03-10;0;2;0;0
Nordeste;BA;2020-03-11;1;3;0;0
Nordeste;BA;2020-03-12;0;3;0;0
Nordeste;BA;2020-03-13;4;7;0;0
Nordeste;BA;2020-03-15;2;9;0;0
Nordeste;BA;2020-03-16;1;10;0;0
Nordeste;BA;2020-03-17;4;14;0;0
Nordeste;BA;2020-03-18;13;27;0;0
Nordeste;BA;2020-03-19;4;31;0;0
Nordeste;BA;2020-03-20;3;34;0;0
Nordeste;BA;2020-03-21;7;41;0;0
Nordeste;BA;2020-03-22;14;55;0;0
Nordeste;BA;2020-03-23;8;63;0;0
Nordeste;BA;2020-03-24;16;79;0;0
Nordeste;BA;2020-03-25;12;91;0;0
Nordeste;BA;2020-03-26;17;108;0;0
Nordeste;BA;2020-03-27;15;123;0;0
Nordeste;BA;2020-03-28;4;127;0;0
Nordeste;BA;2020-03-29;29;156;1;1
Nordeste;BA;2020-03-30;20;176;1;2
Nordeste;BA;2020-03-31;41;217;0;2
Nordeste;BA;2020-04-01;29;246;0;2
Nordeste;BA;2020-04-02;21;267;1;3
Nordeste;BA;2020-04-03;23;290;3;6
Nordeste;BA;2020-04-04;46;336;1;7
Nordeste;BA;2020-04-05;65;401;2;9
Nordeste;BA;2020-04-06;36;437;1;10
Nordeste;BA;2020-04-07;25;462;4;14
Nordeste;BA;2020-04-08;53;515;4;18
Nordeste;BA;2020-04-09;53;568;1;19
Nordeste;BA;2020-04-10;48;616;0;19
Nordeste;BA;2020-04-11;24;640;2;21
Nordeste;BA;2020-04-12;34;674;0;21
Nordeste;BA;2020-04-13;49;723;1;22
Nordeste;BA;2020-04-14;53;776;4;26
Nordeste;BA;2020-04-15;108;884;2;28
Nordeste;BA;2020-04-16;83;967;6;34
Nordeste;BA;2020-04-17;97;1064;2;36
Nordeste;BA;2020-04-18;136;1200;4;40
Nordeste;BA;2020-04-19;49;1249;5;45
Nordeste;BA;2020-04-20;128;1377;2;47
Nordeste;BA;2020-04-21;127;1504;1;48
Nordeste;BA;2020-04-22;141;1645;5;53
Nordeste;BA;2020-04-23;200;1845;9;62
Nordeste;BA;2020-04-24;134;1979;5;67
Nordeste;BA;2020-04-25;137;2116;5;72
Nordeste;BA;2020-04-26;132;2248;2;74
Nordeste;BA;2020-04-27;108;2356;9;83
Nordeste;BA;2020-04-28;208;2564;10;93
Nordeste;BA;2020-04-29;112;2676;7;100
Nordeste;BA;2020-04-30;191;2867;6;106
Nordeste;BA;2020-05-01;273;3140;11;117
Nordeste;BA;2020-05-02;175;3315;6;123
Nordeste;BA;2020-05-03;251;3566;5;128
Nordeste;BA;2020-05-04;168;3734;13;141
Nordeste;BA;2020-05-05;306;4040;5;146
Nordeste;BA;2020-05-06;261;4301;14;160
Nordeste;BA;2020-05-07;227;4528;5;165
Nordeste;BA;2020-05-08;290;4818;18;183
Nordeste;BA;2020-05-09;356;5174;13;196
Nordeste;BA;2020-05-10;384;5558;6;202
Nordeste;BA;2020-05-11;250;5808;12;214
Nordeste;BA;2020-05-12;396;6204;11;225
Nordeste;BA;2020-05-13;343;6547;11;236
Nordeste;BA;2020-05-14;408;6955;26;262
Nordeste;BA;2020-05-15;1173;8128;19;281
Nordeste;BA;2020-05-16;186;8314;5;286
Nordeste;BA;2020-05-17;129;8443;9;295
Nordeste;BA;2020-05-18;438;8881;17;312
Nordeste;BA;2020-05-19;2132;11013;14;326
Nordeste;BA;2020-05-20;184;11197;36;362
Nordeste;BA;2020-05-21;744;11941;14;376
Nordeste;BA;2020-05-22;616;12557;23;399
Nordeste;BA;2020-05-23;443;13000;14;413
Nordeste;BA;2020-05-24;899;13899;47;460
Nordeste;BA;2020-05-25;305;14204;17;477
Nordeste;BA;2020-05-26;362;14566;18;495
Nordeste;BA;2020-05-27;504;15070;36;531
Nordeste;BA;2020-05-28;893;15963;39;570
Nordeste;BA;2020-05-29;954;16917;39;609
Nordeste;BA;2020-05-30;709;17626;29;638
Nordeste;BA;2020-05-31;766;18392;29;667
Nordeste;BA;2020-06-01;506;18898;34;701
Nordeste;BA;2020-06-02;2532;21430;35;736
Nordeste;BA;2020-06-03;1021;22451;26;762
Nordeste;BA;2020-06-04;1012;23463;28;790
Nordeste;BA;2020-06-05;2956;26419;29;819
Nordeste;BA;2020-06-06;977;27396;27;846
Nordeste;BA;2020-06-07;854;28250;33;879
Nordeste;CE;2020-03-16;0;9;0;0
Nordeste;CE;2020-03-17;1;10;0;0
Nordeste;CE;2020-03-18;9;19;0;0
Nordeste;CE;2020-03-19;5;24;0;0
Nordeste;CE;2020-03-20;44;68;0;0
Nordeste;CE;2020-03-21;16;84;0;0
Nordeste;CE;2020-03-22;41;125;0;0
Nordeste;CE;2020-03-23;39;164;0;0
Nordeste;CE;2020-03-24;21;185;0;0
Nordeste;CE;2020-03-25;26;211;0;0
Nordeste;CE;2020-03-26;26;237;3;3
Nordeste;CE;2020-03-27;45;282;0;3
Nordeste;CE;2020-03-28;40;322;1;4
Nordeste;CE;2020-03-29;37;359;1;5
Nordeste;CE;2020-03-30;23;382;0;5
Nordeste;CE;2020-03-31;19;401;2;7
Nordeste;CE;2020-04-01;44;445;2;9
Nordeste;CE;2020-04-02;118;563;12;21
Nordeste;CE;2020-04-03;95;658;1;22
Nordeste;CE;2020-04-04;87;745;1;23
Nordeste;CE;2020-04-05;215;960;12;35
Nordeste;CE;2020-04-06;85;1045;0;35
Nordeste;CE;2020-04-07;143;1188;5;40
Nordeste;CE;2020-04-08;206;1394;17;57
Nordeste;CE;2020-04-09;51;1445;0;57
Nordeste;CE;2020-04-10;113;1558;10;67
Nordeste;CE;2020-04-11;110;1668;7;74
Nordeste;CE;2020-04-12;79;1747;2;76
Nordeste;CE;2020-04-13;188;1935;25;101
Nordeste;CE;2020-04-14;135;2070;10;111
Nordeste;CE;2020-04-15;221;2291;13;124
Nordeste;CE;2020-04-16;121;2412;11;135
Nordeste;CE;2020-04-17;335;2747;20;155
Nordeste;CE;2020-04-18;315;3062;25;180
Nordeste;CE;2020-04-19;244;3306;9;189
Nordeste;CE;2020-04-20;179;3485;17;206
Nordeste;CE;2020-04-21;197;3682;15;221
Nordeste;CE;2020-04-22;434;4116;18;239
Nordeste;CE;2020-04-23;586;4702;32;271
Nordeste;CE;2020-04-24;419;5121;22;293
Nordeste;CE;2020-04-25;546;5667;33;326
Nordeste;CE;2020-04-26;593;6260;50;376
Nordeste;CE;2020-04-27;523;6783;21;397
Nordeste;CE;2020-04-28;202;6985;20;417
Nordeste;CE;2020-04-29;424;7409;33;450
Nordeste;CE;2020-04-30;452;7861;42;492
Nordeste;CE;2020-05-01;139;8000;47;539
Nordeste;CE;2020-05-02;309;8309;99;638
Nordeste;CE;2020-05-03;70;8379;39;677
Nordeste;CE;2020-05-04;2661;11040;35;712
Nordeste;CE;2020-05-05;430;11470;83;795
Nordeste;CE;2020-05-06;840;12310;54;849
Nordeste;CE;2020-05-07;1578;13888;54;903
Nordeste;CE;2020-05-08;1246;15134;94;997
Nordeste;CE;2020-05-09;745;15879;65;1062
Nordeste;CE;2020-05-10;813;16692;52;1114
Nordeste;CE;2020-05-11;907;17599;75;1189
Nordeste;CE;2020-05-12;813;18412;91;1280
Nordeste;CE;2020-05-13;744;19156;109;1389
Nordeste;CE;2020-05-14;1921;21077;24;1413
Nordeste;CE;2020-05-15;1982;23059;153;1566
Nordeste;CE;2020-05-16;736;23795;48;1614
Nordeste;CE;2020-05-17;460;24255;27;1641
Nordeste;CE;2020-05-18;2108;26363;107;1748
Nordeste;CE;2020-05-19;1749;28112;108;1856
Nordeste;CE;2020-05-20;2448;30560;44;1900
Nordeste;CE;2020-05-21;853;31413;261;2161
Nordeste;CE;2020-05-22;3160;34573;90;2251
Nordeste;CE;2020-05-23;549;35122;57;2308
Nordeste;CE;2020-05-24;473;35595;16;2324
Nordeste;CE;2020-05-25;590;36185;169;2493
Nordeste;CE;2020-05-26;836;37021;110;2603
Nordeste;CE;2020-05-27;254;37275;68;2671
Nordeste;CE;2020-05-28;546;37821;62;2733
Nordeste;CE;2020-05-29;574;38395;126;2859
Nordeste;CE;2020-05-30;9427;47822;97;2956
Nordeste;CE;2020-05-31;667;48489;54;3010
Nordeste;CE;2020-06-01;2015;50504;178;3188
Nordeste;CE;2020-06-02;4179;54683;316;3504
Nordeste;CE;2020-06-03;1373;56056;101;3605
Nordeste;CE;2020-06-05;6120;62176;302;3907
Nordeste;CE;2020-06-06;1399;63575;58;3965
Nordeste;CE;2020-06-07;696;64271;17;3982
Nordeste;MA;2020-03-20;0;1;0;0
Nordeste;MA;2020-03-21;1;2;0;0
Nordeste;MA;2020-03-22;0;2;0;0
Nordeste;MA;2020-03-23;6;8;0;0
Nordeste;MA;2020-03-24;0;8;0;0
Nordeste;MA;2020-03-25;0;8;0;0
Nordeste;MA;2020-03-26;2;10;0;0
Nordeste;MA;2020-03-27;3;13;0;0
Nordeste;MA;2020-03-28;2;15;0;0
Nordeste;MA;2020-03-29;6;21;1;1
Nordeste;MA;2020-03-30;9;30;0;1
Nordeste;MA;2020-03-31;21;51;0;1
Nordeste;MA;2020-04-01;19;70;0;1
Nordeste;MA;2020-04-02;10;80;0;1
Nordeste;MA;2020-04-03;7;87;0;1
Nordeste;MA;2020-04-04;8;95;1;2
Nordeste;MA;2020-04-05;37;132;0;2
Nordeste;MA;2020-04-06;39;171;2;4
Nordeste;MA;2020-04-07;58;229;7;11
Nordeste;MA;2020-04-08;43;272;1;12
Nordeste;MA;2020-04-09;21;293;4;16
Nordeste;MA;2020-04-10;51;344;5;21
Nordeste;MA;2020-04-11;54;398;3;24
Nordeste;MA;2020-04-12;47;445;3;27
Nordeste;MA;2020-04-13;33;478;5;32
Nordeste;MA;2020-04-14;152;630;2;34
Nordeste;MA;2020-04-15;65;695;3;37
Nordeste;MA;2020-04-16;102;797;3;40
Nordeste;MA;2020-04-17;243;1040;4;44
Nordeste;MA;2020-04-18;165;1205;4;48
Nordeste;MA;2020-04-19;115;1320;6;54
Nordeste;MA;2020-04-20;76;1396;6;60
Nordeste;MA;2020-04-21;208;1604;6;66
Nordeste;MA;2020-04-22;153;1757;10;76
Nordeste;MA;2020-04-23;194;1951;12;88
Nordeste;MA;2020-04-24;154;2105;12;100
Nordeste;MA;2020-04-25;118;2223;12;112
Nordeste;MA;2020-04-26;187;2410;13;125
Nordeste;MA;2020-04-27;118;2528;20;145
Nordeste;MA;2020-04-28;276;2804;21;166
Nordeste;MA;2020-04-29;386;3190;18;184
Nordeste;MA;2020-04-30;316;3506;20;204
Nordeste;MA;2020-05-01;299;3805;20;224
Nordeste;MA;2020-05-02;235;4040;13;237
Nordeste;MA;2020-05-03;187;4227;12;249
Nordeste;MA;2020-05-04;303;4530;22;271
Nordeste;MA;2020-05-05;498;5028;20;291
Nordeste;MA;2020-05-06;361;5389;14;305
Nordeste;MA;2020-05-07;520;5909;25;330
Nordeste;MA;2020-05-08;856;6765;25;355
Nordeste;MA;2020-05-09;834;7599;24;379
Nordeste;MA;2020-05-10;545;8144;20;399
Nordeste;MA;2020-05-11;382;8526;24;423
Nordeste;MA;2020-05-12;586;9112;21;444
Nordeste;MA;2020-05-13;689;9801;26;470
Nordeste;MA;2020-05-14;938;10739;26;496
Nordeste;MA;2020-05-15;853;11592;28;524
Nordeste;MA;2020-05-16;900;12492;25;549
Nordeste;MA;2020-05-17;746;13238;27;576
Nordeste;MA;2020-05-18;960;14198;28;604
Nordeste;MA;2020-05-19;916;15114;30;634
Nordeste;MA;2020-05-20;944;16058;29;663
Nordeste;MA;2020-05-21;1154;17212;30;693
Nordeste;MA;2020-05-22;1555;18767;29;722
Nordeste;MA;2020-05-23;2424;21191;32;754
Nordeste;MA;2020-05-24;1595;22786;30;784
Nordeste;MA;2020-05-25;1492;24278;33;817
Nordeste;MA;2020-05-26;1867;26145;36;853
Nordeste;MA;2020-05-27;1834;27979;34;887
Nordeste;MA;2020-05-28;2503;30482;24;911
Nordeste;MA;2020-05-29;2138;32620;21;932
Nordeste;MA;2020-05-30;2019;34639;23;955
Nordeste;MA;2020-05-31;658;35297;21;976
Nordeste;MA;2020-06-01;1328;36625;21;997
Nordeste;MA;2020-06-02;1549;38174;31;1028
Nordeste;MA;2020-06-03;2455;40629;34;1062
Nordeste;MA;2020-06-04;2684;43313;33;1095
Nordeste;MA;2020-06-05;2157;45470;37;1132
Nordeste;MA;2020-06-06;2123;47593;38;1170
Nordeste;MA;2020-06-07;944;48537;38;1208
Nordeste;PB;2020-03-12;0;0;0;0
Nordeste;PB;2020-03-13;0;0;0;0
Nordeste;PB;2020-03-14;0;0;0;0
Nordeste;PB;2020-03-15;0;0;0;0
Nordeste;PB;2020-03-16;0;0;0;0
Nordeste;PB;2020-03-17;0;0;0;0
Nordeste;PB;2020-03-18;1;1;0;0
Nordeste;PB;2020-03-19;0;1;0;0
Nordeste;PB;2020-03-20;0;1;0;0
Nordeste;PB;2020-03-21;0;1;0;0
Nordeste;PB;2020-03-22;0;1;0;0
Nordeste;PB;2020-03-23;1;2;0;0
Nordeste;PB;2020-03-24;1;3;0;0
Nordeste;PB;2020-03-25;2;5;0;0
Nordeste;PB;2020-03-26;1;6;0;0
Nordeste;PB;2020-03-27;4;10;0;0
Nordeste;PB;2020-03-28;4;14;0;0
Nordeste;PB;2020-03-29;0;14;0;0
Nordeste;PB;2020-03-30;3;17;0;0
Nordeste;PB;2020-03-31;1;18;1;1
Nordeste;PB;2020-04-01;3;21;0;1
Nordeste;PB;2020-04-02;8;29;0;1
Nordeste;PB;2020-04-03;3;32;0;1
Nordeste;PB;2020-04-04;2;34;2;3
Nordeste;PB;2020-04-05;1;35;1;4
Nordeste;PB;2020-04-06;1;36;0;4
Nordeste;PB;2020-04-07;5;41;0;4
Nordeste;PB;2020-04-08;14;55;3;7
Nordeste;PB;2020-04-09;24;79;4;11
Nordeste;PB;2020-04-10;6;85;0;11
Nordeste;PB;2020-04-11;16;101;2;13
Nordeste;PB;2020-04-12;10;111;0;13
Nordeste;PB;2020-04-13;25;136;3;16
Nordeste;PB;2020-04-14;16;152;5;21
Nordeste;PB;2020-04-15;13;165;3;24
Nordeste;PB;2020-04-16;30;195;2;26
Nordeste;PB;2020-04-17;10;205;2;28
Nordeste;PB;2020-04-18;31;236;1;29
Nordeste;PB;2020-04-19;9;245;3;32
Nordeste;PB;2020-04-20;18;263;1;33
Nordeste;PB;2020-04-21;38;301;6;39
Nordeste;PB;2020-04-22;44;345;1;40
Nordeste;PB;2020-04-23;41;386;4;44
Nordeste;PB;2020-04-24;61;447;2;46
Nordeste;PB;2020-04-25;52;499;3;49
Nordeste;PB;2020-04-26;44;543;1;50
Nordeste;PB;2020-04-27;90;633;3;53
Nordeste;PB;2020-04-28;65;698;4;57
Nordeste;PB;2020-04-29;116;814;5;62
Nordeste;PB;2020-04-30;112;926;5;67
Nordeste;PB;2020-05-01;108;1034;7;74
Nordeste;PB;2020-05-02;135;1169;2;76
Nordeste;PB;2020-05-03;50;1219;3;79
Nordeste;PB;2020-05-04;142;1361;6;85
Nordeste;PB;2020-05-05;132;1493;7;92
Nordeste;PB;2020-05-06;164;1657;9;101
Nordeste;PB;2020-05-07;192;1849;10;111
Nordeste;PB;2020-05-08;181;2030;3;114
Nordeste;PB;2020-05-09;126;2156;10;124
Nordeste;PB;2020-05-10;185;2341;11;135
Nordeste;PB;2020-05-11;184;2525;4;139
Nordeste;PB;2020-05-12;252;2777;15;154
Nordeste;PB;2020-05-13;268;3045;3;157
Nordeste;PB;2020-05-14;316;3361;3;160
Nordeste;PB;2020-05-15;378;3739;10;170
Nordeste;PB;2020-05-16;324;4063;13;183
Nordeste;PB;2020-05-17;284;4347;11;194
Nordeste;PB;2020-05-18;439;4786;13;207
Nordeste;PB;2020-05-19;514;5300;12;219
Nordeste;PB;2020-05-20;538;5838;11;230
Nordeste;PB;2020-05-21;400;6238;15;245
Nordeste;PB;2020-05-22;644;6882;3;248
Nordeste;PB;2020-05-23;626;7508;10;258
Nordeste;PB;2020-05-24;315;7823;14;272
Nordeste;PB;2020-05-25;193;8016;7;279
Nordeste;PB;2020-05-26;903;8919;7;286
Nordeste;PB;2020-05-27;1290;10209;12;298
Nordeste;PB;2020-05-28;923;11132;20;318
Nordeste;PB;2020-05-29;879;12011;9;327
Nordeste;PB;2020-05-30;851;12862;19;346
Nordeste;PB;2020-05-31;300;13162;14;360
Nordeste;PB;2020-06-01;533;13695;10;370
Nordeste;PB;2020-06-02;1164;14859;9;379
Nordeste;PB;2020-06-03;1159;16018;35;414
Nordeste;PB;2020-06-04;1561;17579;24;438
Nordeste;PB;2020-06-05;1000;18579;13;451
Nordeste;PB;2020-06-06;1208;19787;16;467
Nordeste;PB;2020-06-07;523;20310;17;484
Nordeste;PE;2020-03-12;0;2;0;0
Nordeste;PE;2020-03-13;0;2;0;0
Nordeste;PE;2020-03-14;5;7;0;0
Nordeste;PE;2020-03-15;1;8;0;0
Nordeste;PE;2020-03-16;0;8;0;0
Nordeste;PE;2020-03-17;10;18;0;0
Nordeste;PE;2020-03-18;1;19;0;0
Nordeste;PE;2020-03-19;9;28;0;0
Nordeste;PE;2020-03-20;3;31;0;0
Nordeste;PE;2020-03-21;2;33;0;0
Nordeste;PE;2020-03-22;4;37;0;0
Nordeste;PE;2020-03-23;5;42;0;0
Nordeste;PE;2020-03-24;0;42;0;0
Nordeste;PE;2020-03-25;4;46;1;1
Nordeste;PE;2020-03-26;2;48;2;3
Nordeste;PE;2020-03-27;9;57;1;4
Nordeste;PE;2020-03-28;11;68;1;5
Nordeste;PE;2020-03-29;5;73;0;5
Nordeste;PE;2020-03-30;4;77;1;6
Nordeste;PE;2020-03-31;10;87;0;6
Nordeste;PE;2020-04-01;8;95;2;8
Nordeste;PE;2020-04-02;11;106;1;9
Nordeste;PE;2020-04-03;30;136;1;10
Nordeste;PE;2020-04-04;40;176;4;14
Nordeste;PE;2020-04-05;25;201;7;21
Nordeste;PE;2020-04-06;22;223;9;30
Nordeste;PE;2020-04-07;129;352;4;34
Nordeste;PE;2020-04-08;49;401;12;46
Nordeste;PE;2020-04-09;154;555;10;56
Nordeste;PE;2020-04-10;129;684;9;65
Nordeste;PE;2020-04-11;132;816;7;72
Nordeste;PE;2020-04-12;144;960;13;85
Nordeste;PE;2020-04-13;194;1154;17;102
Nordeste;PE;2020-04-14;130;1284;13;115
Nordeste;PE;2020-04-15;200;1484;28;143
Nordeste;PE;2020-04-16;199;1683;17;160
Nordeste;PE;2020-04-17;323;2006;26;186
Nordeste;PE;2020-04-18;187;2193;19;205
Nordeste;PE;2020-04-19;266;2459;11;216
Nordeste;PE;2020-04-20;231;2690;18;234
Nordeste;PE;2020-04-21;218;2908;26;260
Nordeste;PE;2020-04-22;390;3298;22;282
Nordeste;PE;2020-04-23;306;3604;30;312
Nordeste;PE;2020-04-24;395;3999;40;352
Nordeste;PE;2020-04-25;508;4507;29;381
Nordeste;PE;2020-04-26;391;4898;34;415
Nordeste;PE;2020-04-27;460;5358;35;450
Nordeste;PE;2020-04-28;366;5724;58;508
Nordeste;PE;2020-04-29;470;6194;30;538
Nordeste;PE;2020-04-30;682;6876;27;565
Nordeste;PE;2020-05-01;458;7334;38;603
Nordeste;PE;2020-05-02;811;8145;25;628
Nordeste;PE;2020-05-03;498;8643;24;652
Nordeste;PE;2020-05-04;220;8863;39;691
Nordeste;PE;2020-05-05;462;9325;58;749
Nordeste;PE;2020-05-06;556;9881;54;803
Nordeste;PE;2020-05-07;943;10824;42;845
Nordeste;PE;2020-05-08;763;11587;82;927
Nordeste;PE;2020-05-09;883;12470;45;972
Nordeste;PE;2020-05-10;805;13275;75;1047
Nordeste;PE;2020-05-11;493;13768;40;1087
Nordeste;PE;2020-05-12;541;14309;70;1157
Nordeste;PE;2020-05-13;592;14901;67;1224
Nordeste;PE;2020-05-14;687;15588;74;1298
Nordeste;PE;2020-05-15;621;16209;83;1381
Nordeste;PE;2020-05-16;2279;18488;80;1461
Nordeste;PE;2020-05-17;964;19452;55;1516
Nordeste;PE;2020-05-18;642;20094;124;1640
Nordeste;PE;2020-05-19;1148;21242;101;1741
Nordeste;PE;2020-05-20;1318;22560;93;1834
Nordeste;PE;2020-05-21;1351;23911;91;1925
Nordeste;PE;2020-05-22;1849;25760;132;2057
Nordeste;PE;2020-05-23;1026;26786;87;2144
Nordeste;PE;2020-05-24;973;27759;56;2200
Nordeste;PE;2020-05-25;607;28366;48;2248
Nordeste;PE;2020-05-26;488;28854;80;2328
Nordeste;PE;2020-05-27;1065;29919;140;2468
Nordeste;PE;2020-05-28;794;30713;98;2566
Nordeste;PE;2020-05-29;1542;32255;103;2669
Nordeste;PE;2020-05-30;1172;33427;71;2740
Nordeste;PE;2020-05-31;1023;34450;67;2807
Nordeste;PE;2020-06-01;450;34900;68;2875
Nordeste;PE;2020-06-02;608;35508;58;2933
Nordeste;PE;2020-06-03;955;36463;79;3012
Nordeste;PE;2020-06-04;1044;37507;122;3134
Nordeste;PE;2020-06-05;1004;38511;71;3205
Nordeste;PE;2020-06-06;850;39361;65;3270
Nordeste;PE;2020-06-07;881;40242;35;3305
Nordeste;PI;2020-03-19;0;3;0;0
Nordeste;PI;2020-03-20;1;4;0;0
Nordeste;PI;2020-03-21;0;4;0;0
Nordeste;PI;2020-03-22;2;6;0;0
Nordeste;PI;2020-03-23;0;6;0;0
Nordeste;PI;2020-03-24;2;8;0;0
Nordeste;PI;2020-03-25;0;8;0;0
Nordeste;PI;2020-03-26;1;9;0;0
Nordeste;PI;2020-03-27;1;10;1;1
Nordeste;PI;2020-03-28;1;11;0;1
Nordeste;PI;2020-03-30;7;18;3;4
Nordeste;PI;2020-03-31;0;18;0;4
Nordeste;PI;2020-04-01;1;19;0;4
Nordeste;PI;2020-04-02;0;19;0;4
Nordeste;PI;2020-04-03;3;22;0;4
Nordeste;PI;2020-04-04;2;24;0;4
Nordeste;PI;2020-04-05;0;24;0;4
Nordeste;PI;2020-04-06;2;26;0;4
Nordeste;PI;2020-04-07;5;31;1;5
Nordeste;PI;2020-04-08;7;38;1;6
Nordeste;PI;2020-04-09;2;40;1;7
Nordeste;PI;2020-04-10;1;41;0;7
Nordeste;PI;2020-04-11;3;44;0;7
Nordeste;PI;2020-04-12;7;51;0;7
Nordeste;PI;2020-04-13;7;58;1;8
Nordeste;PI;2020-04-14;17;75;0;8
Nordeste;PI;2020-04-15;16;91;0;8
Nordeste;PI;2020-04-16;11;102;0;8
Nordeste;PI;2020-04-17;21;123;1;9
Nordeste;PI;2020-04-18;21;144;1;10
Nordeste;PI;2020-04-19;14;158;2;12
Nordeste;PI;2020-04-20;28;186;2;14
Nordeste;PI;2020-04-21;20;206;1;15
Nordeste;PI;2020-04-22;11;217;0;15
Nordeste;PI;2020-04-23;39;256;1;16
Nordeste;PI;2020-04-24;41;297;1;17
Nordeste;PI;2020-04-25;34;331;1;18
Nordeste;PI;2020-04-26;33;364;2;20
Nordeste;PI;2020-04-27;44;408;1;21
Nordeste;PI;2020-04-28;46;454;3;24
Nordeste;PI;2020-04-29;59;513;0;24
Nordeste;PI;2020-04-30;87;600;0;24
Nordeste;PI;2020-05-01;65;665;2;26
Nordeste;PI;2020-05-02;77;742;2;28
Nordeste;PI;2020-05-03;42;784;0;28
Nordeste;PI;2020-05-04;91;875;1;29
Nordeste;PI;2020-05-05;74;949;1;30
Nordeste;PI;2020-05-06;102;1051;5;35
Nordeste;PI;2020-05-07;80;1131;2;37
Nordeste;PI;2020-05-08;102;1233;1;38
Nordeste;PI;2020-05-09;45;1278;4;42
Nordeste;PI;2020-05-10;54;1332;3;45
Nordeste;PI;2020-05-11;111;1443;4;49
Nordeste;PI;2020-05-12;169;1612;8;57
Nordeste;PI;2020-05-13;172;1784;3;60
Nordeste;PI;2020-05-14;121;1905;0;60
Nordeste;PI;2020-05-15;180;2085;5;65
Nordeste;PI;2020-05-16;167;2252;7;72
Nordeste;PI;2020-05-17;35;2287;8;80
Nordeste;PI;2020-05-18;153;2440;5;85
Nordeste;PI;2020-05-19;197;2637;2;87
Nordeste;PI;2020-05-20;215;2852;4;91
Nordeste;PI;2020-05-21;222;3074;2;93
Nordeste;PI;2020-05-22;184;3258;6;99
Nordeste;PI;2020-05-23;132;3390;8;107
Nordeste;PI;2020-05-24;160;3550;3;110
Nordeste;PI;2020-05-25;170;3720;9;119
Nordeste;PI;2020-05-26;246;3966;15;134
Nordeste;PI;2020-05-27;277;4243;4;138
Nordeste;PI;2020-05-28;260;4503;8;146
Nordeste;PI;2020-05-29;242;4745;11;157
Nordeste;PI;2020-05-30;186;4931;4;161
Nordeste;PI;2020-05-31;188;5119;7;168
Nordeste;PI;2020-06-01;387;5506;12;180
Nordeste;PI;2020-06-02;322;5828;12;192
Nordeste;PI;2020-06-03;236;6064;10;202
Nordeste;PI;2020-06-04;653;6717;15;217
Nordeste;PI;2020-06-05;388;7105;7;224
Nordeste;PI;2020-06-06;373;7478;15;239
Nordeste;PI;2020-06-07;143;7621;15;254
Nordeste;RN;2020-03-12;0;1;0;0
Nordeste;RN;2020-03-13;0;1;0;0
Nordeste;RN;2020-03-16;0;1;0;0
Nordeste;RN;2020-03-18;0;1;0;0
Nordeste;RN;2020-03-20;5;6;0;0
Nordeste;RN;2020-03-21;3;9;0;0
Nordeste;RN;2020-03-22;4;13;0;0
Nordeste;RN;2020-03-24;1;14;0;0
Nordeste;RN;2020-03-25;0;14;0;0
Nordeste;RN;2020-03-26;5;19;0;0
Nordeste;RN;2020-03-27;9;28;0;0
Nordeste;RN;2020-03-28;40;68;1;1
Nordeste;RN;2020-03-30;9;77;0;1
Nordeste;RN;2020-03-31;5;82;0;1
Nordeste;RN;2020-04-01;10;92;1;2
Nordeste;RN;2020-04-02;14;106;0;2
Nordeste;RN;2020-04-03;70;176;2;4
Nordeste;RN;2020-04-04;39;215;2;6
Nordeste;RN;2020-04-05;31;246;1;7
Nordeste;RN;2020-04-07;8;254;1;8
Nordeste;RN;2020-04-08;7;261;3;11
Nordeste;RN;2020-04-10;2;263;0;11
Nordeste;RN;2020-04-11;26;289;2;13
Nordeste;RN;2020-04-12;50;339;4;17
Nordeste;RN;2020-04-13;37;376;1;18
Nordeste;RN;2020-04-14;23;399;1;19
Nordeste;RN;2020-04-15;1;400;1;20
Nordeste;RN;2020-04-16;63;463;3;23
Nordeste;RN;2020-04-17;53;516;1;24
Nordeste;RN;2020-04-18;45;561;2;26
Nordeste;RN;2020-04-19;34;595;1;27
Nordeste;RN;2020-04-20;13;608;1;28
Nordeste;RN;2020-04-21;38;646;1;29
Nordeste;RN;2020-04-22;62;708;5;34
Nordeste;RN;2020-04-23;46;754;4;38
Nordeste;RN;2020-04-24;27;781;2;40
Nordeste;RN;2020-04-25;44;825;4;44
Nordeste;RN;2020-04-26;7;832;1;45
Nordeste;RN;2020-04-27;25;857;3;48
Nordeste;RN;2020-04-28;229;1086;6;54
Nordeste;RN;2020-04-29;91;1177;2;56
Nordeste;RN;2020-04-30;120;1297;0;56
Nordeste;RN;2020-05-01;69;1366;3;59
Nordeste;RN;2020-05-02;26;1392;2;61
Nordeste;RN;2020-05-03;29;1421;1;62
Nordeste;RN;2020-05-04;115;1536;6;68
Nordeste;RN;2020-05-05;108;1644;4;72
Nordeste;RN;2020-05-06;95;1739;4;76
Nordeste;RN;2020-05-07;82;1821;5;81
Nordeste;RN;2020-05-08;98;1919;6;87
Nordeste;RN;2020-05-10;11;1930;0;87
Nordeste;RN;2020-05-11;103;2033;6;93
Nordeste;RN;2020-05-12;334;2367;12;105
Nordeste;RN;2020-05-13;170;2537;12;117
Nordeste;RN;2020-05-14;249;2786;5;122
Nordeste;RN;2020-05-16;218;3004;14;136
Nordeste;RN;2020-05-17;134;3138;3;139
Nordeste;RN;2020-05-18;345;3483;21;160
Nordeste;RN;2020-05-19;313;3796;10;170
Nordeste;RN;2020-05-20;264;4060;8;178
Nordeste;RN;2020-05-21;191;4251;3;181
Nordeste;RN;2020-05-22;348;4599;3;184
Nordeste;RN;2020-05-24;175;4774;28;212
Nordeste;RN;2020-05-25;698;5472;8;220
Nordeste;RN;2020-05-26;158;5630;22;242
Nordeste;RN;2020-05-28;833;6463;26;268
Nordeste;RN;2020-05-29;939;7402;37;305
Nordeste;RN;2020-05-31;606;8008;18;323
Nordeste;RN;2020-06-01;225;8233;18;341
Nordeste;RN;2020-06-02;916;9149;26;367
Nordeste;RN;2020-06-03;133;9282;11;378
Nordeste;RN;2020-06-04;151;9433;9;387
Nordeste;RN;2020-06-05;16;9449;23;410
Nordeste;SE;2020-03-14;0;1;0;0
Nordeste;SE;2020-03-16;4;5;0;0
Nordeste;SE;2020-03-18;1;6;0;0
Nordeste;SE;2020-03-20;1;7;0;0
Nordeste;SE;2020-03-21;3;10;0;0
Nordeste;SE;2020-03-24;5;15;0;0
Nordeste;SE;2020-03-25;1;16;0;0
Nordeste;SE;2020-03-27;0;16;0;0
Nordeste;SE;2020-03-30;2;18;0;0
Nordeste;SE;2020-03-31;1;19;0;0
Nordeste;SE;2020-04-01;3;22;0;0
Nordeste;SE;2020-04-02;2;24;2;2
Nordeste;SE;2020-04-03;3;27;0;2
Nordeste;SE;2020-04-04;5;32;1;3
Nordeste;SE;2020-04-06;0;32;1;4
Nordeste;SE;2020-04-07;4;36;0;4
Nordeste;SE;2020-04-08;3;39;0;4
Nordeste;SE;2020-04-09;1;40;0;4
Nordeste;SE;2020-04-10;2;42;0;4
Nordeste;SE;2020-04-11;2;44;0;4
Nordeste;SE;2020-04-13;1;45;0;4
Nordeste;SE;2020-04-14;1;46;0;4
Nordeste;SE;2020-04-15;2;48;0;4
Nordeste;SE;2020-04-16;5;53;0;4
Nordeste;SE;2020-04-17;5;58;0;4
Nordeste;SE;2020-04-18;13;71;1;5
Nordeste;SE;2020-04-19;15;86;0;5
Nordeste;SE;2020-04-20;6;92;0;5
Nordeste;SE;2020-04-21;25;117;2;7
Nordeste;SE;2020-04-22;1;118;0;7
Nordeste;SE;2020-04-23;17;135;1;8
Nordeste;SE;2020-04-24;10;145;0;8
Nordeste;SE;2020-04-25;9;154;1;9
Nordeste;SE;2020-04-26;21;175;0;9
Nordeste;SE;2020-04-27;36;211;2;11
Nordeste;SE;2020-04-28;69;280;0;11
Nordeste;SE;2020-04-30;173;453;3;14
Nordeste;SE;2020-05-01;64;517;0;14
Nordeste;SE;2020-05-02;84;601;0;14
Nordeste;SE;2020-05-03;129;730;0;14
Nordeste;SE;2020-05-04;42;772;3;17
Nordeste;SE;2020-05-05;126;898;4;21
Nordeste;SE;2020-05-06;100;998;2;23
Nordeste;SE;2020-05-07;216;1214;2;25
Nordeste;SE;2020-05-08;224;1438;3;28
Nordeste;SE;2020-05-09;150;1588;5;33
Nordeste;SE;2020-05-10;183;1771;1;34
Nordeste;SE;2020-05-11;29;1800;3;37
Nordeste;SE;2020-05-12;232;2032;0;37
Nordeste;SE;2020-05-13;236;2268;5;42
Nordeste;SE;2020-05-14;226;2494;5;47
Nordeste;SE;2020-05-15;374;2868;3;50
Nordeste;SE;2020-05-16;267;3135;3;53
Nordeste;SE;2020-05-17;208;3343;4;57
Nordeste;SE;2020-05-18;223;3566;2;59
Nordeste;SE;2020-05-19;401;3967;4;63
Nordeste;SE;2020-05-20;310;4277;6;69
Nordeste;SE;2020-05-21;457;4734;7;76
Nordeste;SE;2020-05-22;188;4922;6;82
Nordeste;SE;2020-05-23;209;5131;4;86
Nordeste;SE;2020-05-24;183;5314;7;93
Nordeste;SE;2020-05-25;134;5448;10;103
Nordeste;SE;2020-05-26;287;5735;13;116
Nordeste;SE;2020-05-27;177;5912;11;127
Nordeste;SE;2020-05-28;244;6156;8;135
Nordeste;SE;2020-05-29;306;6462;7;142
Nordeste;SE;2020-05-30;343;6805;7;149
Nordeste;SE;2020-05-31;194;6999;9;158
Nordeste;SE;2020-06-01;234;7233;8;166
Nordeste;SE;2020-06-02;322;7555;6;172
Nordeste;SE;2020-06-03;434;7989;8;180
Nordeste;SE;2020-06-04;211;8200;6;186
Nordeste;SE;2020-06-05;377;8577;12;198
Nordeste;SE;2020-06-06;395;8972;10;208
Nordeste;SE;2020-06-07;318;9290;9;217
Norte;AC;2020-03-17;0;3;0;0
Norte;AC;2020-03-18;0;3;0;0
Norte;AC;2020-03-19;1;4;0;0
Norte;AC;2020-03-20;3;7;0;0
Norte;AC;2020-03-21;4;11;0;0
Norte;AC;2020-03-22;0;11;0;0
Norte;AC;2020-03-23;6;17;0;0
Norte;AC;2020-03-24;4;21;0;0
Norte;AC;2020-03-25;2;23;0;0
Norte;AC;2020-03-26;0;23;0;0
Norte;AC;2020-03-27;2;25;0;0
Norte;AC;2020-03-28;0;25;0;0
Norte;AC;2020-03-29;9;34;0;0
Norte;AC;2020-03-30;7;41;0;0
Norte;AC;2020-03-31;1;42;0;0
Norte;AC;2020-04-01;1;43;0;0
Norte;AC;2020-04-02;2;45;0;0
Norte;AC;2020-04-03;1;46;0;0
Norte;AC;2020-04-04;0;46;0;0
Norte;AC;2020-04-05;2;48;0;0
Norte;AC;2020-04-06;2;50;1;1
Norte;AC;2020-04-07;0;50;1;2
Norte;AC;2020-04-08;8;58;0;2
Norte;AC;2020-04-09;4;62;0;2
Norte;AC;2020-04-10;8;70;0;2
Norte;AC;2020-04-11;2;72;0;2
Norte;AC;2020-04-12;5;77;0;2
Norte;AC;2020-04-13;13;90;1;3
Norte;AC;2020-04-14;9;99;0;3
Norte;AC;2020-04-15;2;101;1;4
Norte;AC;2020-04-16;14;115;1;5
Norte;AC;2020-04-17;20;135;0;5
Norte;AC;2020-04-18;7;142;1;6
Norte;AC;2020-04-19;21;163;0;6
Norte;AC;2020-04-20;13;176;2;8
Norte;AC;2020-04-21;19;195;0;8
Norte;AC;2020-04-22;19;214;0;8
Norte;AC;2020-04-23;13;227;2;10
Norte;AC;2020-04-24;7;234;1;11
Norte;AC;2020-04-25;24;258;0;11
Norte;AC;2020-04-26;21;279;0;11
Norte;AC;2020-04-27;22;301;3;14
Norte;AC;2020-04-28;16;317;2;16
Norte;AC;2020-04-29;37;354;2;18
Norte;AC;2020-04-30;50;404;1;19
Norte;AC;2020-05-01;83;487;0;19
Norte;AC;2020-05-02;66;553;3;22
Norte;AC;2020-05-03;105;658;3;25
Norte;AC;2020-05-04;75;733;3;28
Norte;AC;2020-05-05;84;817;1;29
Norte;AC;2020-05-06;126;943;6;35
Norte;AC;2020-05-07;71;1014;1;36
Norte;AC;2020-05-08;163;1177;2;38
Norte;AC;2020-05-09;158;1335;2;40
Norte;AC;2020-05-10;112;1447;1;41
Norte;AC;2020-05-11;13;1460;3;44
Norte;AC;2020-05-12;130;1590;7;51
Norte;AC;2020-05-13;104;1694;1;52
Norte;AC;2020-05-14;46;1740;3;55
Norte;AC;2020-05-15;45;1785;2;57
Norte;AC;2020-05-16;82;1867;2;59
Norte;AC;2020-05-17;129;1996;3;62
Norte;AC;2020-05-18;238;2234;5;67
Norte;AC;2020-05-19;248;2482;6;73
Norte;AC;2020-05-20;335;2817;2;75
Norte;AC;2020-05-21;286;3103;3;78
Norte;AC;2020-05-22;240;3343;2;80
Norte;AC;2020-05-23;524;3867;7;87
Norte;AC;2020-05-24;293;4160;5;92
Norte;AC;2020-05-25;341;4501;5;97
Norte;AC;2020-05-26;280;4781;8;105
Norte;AC;2020-05-27;470;5251;8;113
Norte;AC;2020-05-28;349;5600;9;122
Norte;AC;2020-05-29;241;5841;13;135
Norte;AC;2020-05-30;231;6072;7;142
Norte;AC;2020-05-31;147;6219;6;148
Norte;AC;2020-06-01;107;6326;13;161
Norte;AC;2020-06-02;139;6465;4;165
Norte;AC;2020-06-03;214;6679;6;171
Norte;AC;2020-06-04;342;7021;10;181
Norte;AC;2020-06-05;263;7284;9;190
Norte;AC;2020-06-06;241;7525;11;201
Norte;AC;2020-06-07;458;7983;6;207
Norte;AM;2020-03-13;0;2;0;0
Norte;AM;2020-03-18;0;2;0;0
Norte;AM;2020-03-19;1;3;0;0
Norte;AM;2020-03-20;4;7;0;0
Norte;AM;2020-03-21;4;11;0;0
Norte;AM;2020-03-22;15;26;0;0
Norte;AM;2020-03-23;6;32;0;0
Norte;AM;2020-03-24;15;47;1;1
Norte;AM;2020-03-25;7;54;0;1
Norte;AM;2020-03-26;13;67;0;1
Norte;AM;2020-03-27;14;81;0;1
Norte;AM;2020-03-28;30;111;0;1
Norte;AM;2020-03-29;29;140;0;1
Norte;AM;2020-03-30;11;151;1;2
Norte;AM;2020-03-31;24;175;1;3
Norte;AM;2020-04-01;25;200;0;3
Norte;AM;2020-04-02;29;229;0;3
Norte;AM;2020-04-03;31;260;4;7
Norte;AM;2020-04-04;51;311;5;12
Norte;AM;2020-04-05;106;417;3;15
Norte;AM;2020-04-06;115;532;4;19
Norte;AM;2020-04-07;104;636;4;23
Norte;AM;2020-04-08;168;804;7;30
Norte;AM;2020-04-09;95;899;10;40
Norte;AM;2020-04-10;82;981;10;50
Norte;AM;2020-04-11;68;1049;3;53
Norte;AM;2020-04-12;157;1206;9;62
Norte;AM;2020-04-13;69;1275;9;71
Norte;AM;2020-04-14;209;1484;19;90
Norte;AM;2020-04-15;70;1554;16;106
Norte;AM;2020-04-16;165;1719;18;124
Norte;AM;2020-04-17;90;1809;21;145
Norte;AM;2020-04-18;88;1897;16;161
Norte;AM;2020-04-19;147;2044;21;182
Norte;AM;2020-04-20;116;2160;3;185
Norte;AM;2020-04-21;110;2270;8;193
Norte;AM;2020-04-22;209;2479;13;206
Norte;AM;2020-04-23;409;2888;28;234
Norte;AM;2020-04-24;306;3194;21;255
Norte;AM;2020-04-25;441;3635;32;287
Norte;AM;2020-04-26;198;3833;17;304
Norte;AM;2020-04-27;95;3928;16;320
Norte;AM;2020-04-28;409;4337;31;351
Norte;AM;2020-04-29;464;4801;29;380
Norte;AM;2020-04-30;453;5254;45;425
Norte;AM;2020-05-01;469;5723;51;476
Norte;AM;2020-05-02;339;6062;25;501
Norte;AM;2020-05-03;621;6683;47;548
Norte;AM;2020-05-04;630;7313;37;585
Norte;AM;2020-05-05;796;8109;64;649
Norte;AM;2020-05-06;1134;9243;102;751
Norte;AM;2020-05-07;856;10099;55;806
Norte;AM;2020-05-08;628;10727;68;874
Norte;AM;2020-05-09;1198;11925;88;962
Norte;AM;2020-05-10;674;12599;42;1004
Norte;AM;2020-05-11;320;12919;31;1035
Norte;AM;2020-05-12;1249;14168;63;1098
Norte;AM;2020-05-13;1648;15816;62;1160
Norte;AM;2020-05-14;1365;17181;75;1235
Norte;AM;2020-05-15;1211;18392;96;1331
Norte;AM;2020-05-16;1285;19677;44;1375
Norte;AM;2020-05-17;651;20328;38;1413
Norte;AM;2020-05-18;585;20913;20;1433
Norte;AM;2020-05-19;1219;22132;58;1491
Norte;AM;2020-05-20;1572;23704;70;1561
Norte;AM;2020-05-21;1663;25367;59;1620
Norte;AM;2020-05-22;1671;27038;49;1669
Norte;AM;2020-05-23;1764;28802;75;1744
Norte;AM;2020-05-24;1065;29867;14;1758
Norte;AM;2020-05-25;415;30282;23;1781
Norte;AM;2020-05-26;1667;31949;71;1852
Norte;AM;2020-05-27;1559;33508;39;1891
Norte;AM;2020-05-28;2638;36146;73;1964
Norte;AM;2020-05-29;2763;38909;47;2011
Norte;AM;2020-05-30;1651;40560;36;2047
Norte;AM;2020-05-31;818;41378;5;2052
Norte;AM;2020-06-01;396;41774;19;2071
Norte;AM;2020-06-02;1421;43195;31;2102
Norte;AM;2020-06-03;1152;44347;36;2138
Norte;AM;2020-06-04;2126;46473;20;2158
Norte;AM;2020-06-05;1193;47666;41;2199
Norte;AM;2020-06-06;1119;48785;33;2232
Norte;AM;2020-06-07;484;49269;18;2250
Norte;AP;2020-03-20;0;1;0;0
Norte;AP;2020-03-21;0;1;0;0
Norte;AP;2020-03-22;0;1;0;0
Norte;AP;2020-03-23;0;1;0;0
Norte;AP;2020-03-24;0;1;0;0
Norte;AP;2020-03-25;1;2;0;0
Norte;AP;2020-03-26;0;2;0;0
Norte;AP;2020-03-27;1;3;0;0
Norte;AP;2020-03-28;1;4;0;0
Norte;AP;2020-03-29;4;8;0;0
Norte;AP;2020-03-30;0;8;0;0
Norte;AP;2020-03-31;2;10;0;0
Norte;AP;2020-04-01;1;11;0;0
Norte;AP;2020-04-02;1;12;0;0
Norte;AP;2020-04-03;7;19;0;0
Norte;AP;2020-04-04;10;29;1;1
Norte;AP;2020-04-05;3;32;0;1
Norte;AP;2020-04-06;7;39;1;2
Norte;AP;2020-04-07;12;51;0;2
Norte;AP;2020-04-08;56;107;0;2
Norte;AP;2020-04-09;3;110;0;2
Norte;AP;2020-04-10;56;166;0;2
Norte;AP;2020-04-11;27;193;3;5
Norte;AP;2020-04-12;44;237;0;5
Norte;AP;2020-04-13;7;244;1;6
Norte;AP;2020-04-14;64;308;1;7
Norte;AP;2020-04-15;34;342;0;7
Norte;AP;2020-04-16;20;362;3;10
Norte;AP;2020-04-17;13;375;0;10
Norte;AP;2020-04-18;25;400;0;10
Norte;AP;2020-04-19;16;416;1;11
Norte;AP;2020-04-20;19;435;2;13
Norte;AP;2020-04-21;31;466;0;13
Norte;AP;2020-04-22;26;492;1;14
Norte;AP;2020-04-23;63;555;2;16
Norte;AP;2020-04-24;93;648;2;18
Norte;AP;2020-04-25;41;689;2;20
Norte;AP;2020-04-26;132;821;3;23
Norte;AP;2020-04-27;21;842;3;26
Norte;AP;2020-04-28;76;918;2;28
Norte;AP;2020-04-29;98;1016;3;31
Norte;AP;2020-04-30;64;1080;3;34
Norte;AP;2020-05-01;41;1121;3;37
Norte;AP;2020-05-02;66;1187;3;40
Norte;AP;2020-05-03;295;1482;3;43
Norte;AP;2020-05-04;251;1733;6;49
Norte;AP;2020-05-05;198;1931;6;55
Norte;AP;2020-05-06;115;2046;1;56
Norte;AP;2020-05-07;153;2199;5;61
Norte;AP;2020-05-08;123;2322;5;66
Norte;AP;2020-05-09;171;2493;3;69
Norte;AP;2020-05-10;120;2613;3;72
Norte;AP;2020-05-11;58;2671;1;73
Norte;AP;2020-05-12;239;2910;13;86
Norte;AP;2020-05-13;95;3005;8;94
Norte;AP;2020-05-14;423;3428;7;101
Norte;AP;2020-05-15;202;3630;2;103
Norte;AP;2020-05-16;204;3834;5;108
Norte;AP;2020-05-17;118;3952;11;119
Norte;AP;2020-05-18;71;4023;8;127
Norte;AP;2020-05-19;287;4310;9;136
Norte;AP;2020-05-20;239;4549;6;142
Norte;AP;2020-05-21;639;5188;9;151
Norte;AP;2020-05-22;467;5655;6;157
Norte;AP;2020-05-24;698;6353;6;163
Norte;AP;2020-05-25;231;6584;5;168
Norte;AP;2020-05-26;383;6967;5;173
Norte;AP;2020-05-27;652;7619;10;183
Norte;AP;2020-05-28;533;8152;15;198
Norte;AP;2020-05-29;317;8469;9;207
Norte;AP;2020-05-30;844;9313;8;215
Norte;AP;2020-05-31;289;9602;7;222
Norte;AP;2020-06-01;288;9890;6;228
Norte;AP;2020-06-02;621;10511;9;237
Norte;AP;2020-06-03;596;11107;10;247
Norte;AP;2020-06-04;444;11551;7;254
Norte;AP;2020-06-05;776;12327;6;260
Norte;AP;2020-06-06;446;12773;9;269
Norte;AP;2020-06-07;272;13045;3;272
Norte;PA;2020-03-18;0;1;0;0
Norte;PA;2020-03-19;0;1;0;0
Norte;PA;2020-03-20;1;2;0;0
Norte;PA;2020-03-21;0;2;0;0
Norte;PA;2020-03-22;2;4;0;0
Norte;PA;2020-03-23;1;5;0;0
Norte;PA;2020-03-24;0;5;0;0
Norte;PA;2020-03-25;2;7;0;0
Norte;PA;2020-03-26;6;13;0;0
Norte;PA;2020-03-27;3;16;0;0
Norte;PA;2020-03-28;2;18;0;0
Norte;PA;2020-03-29;2;20;0;0
Norte;PA;2020-03-30;6;26;0;0
Norte;PA;2020-03-31;8;34;0;0
Norte;PA;2020-04-01;7;41;1;1
Norte;PA;2020-04-02;8;49;0;1
Norte;PA;2020-04-03;26;75;0;1
Norte;PA;2020-04-04;7;82;0;1
Norte;PA;2020-04-05;4;86;0;1
Norte;PA;2020-04-06;37;123;4;5
Norte;PA;2020-04-07;31;154;0;5
Norte;PA;2020-04-08;11;165;1;6
Norte;PA;2020-04-09;4;169;1;7
Norte;PA;2020-04-10;48;217;2;9
Norte;PA;2020-04-11;20;237;2;11
Norte;PA;2020-04-12;22;259;3;14
Norte;PA;2020-04-13;51;310;0;14
Norte;PA;2020-04-14;74;384;7;21
Norte;PA;2020-04-15;103;487;0;21
Norte;PA;2020-04-16;70;557;5;26
Norte;PA;2020-04-17;70;627;6;32
Norte;PA;2020-04-18;14;641;1;33
Norte;PA;2020-04-19;44;685;1;34
Norte;PA;2020-04-20;217;902;1;35
Norte;PA;2020-04-21;124;1026;3;38
Norte;PA;2020-04-22;169;1195;5;43
Norte;PA;2020-04-23;72;1267;10;53
Norte;PA;2020-04-24;312;1579;33;86
Norte;PA;2020-04-25;166;1745;9;95
Norte;PA;2020-04-26;325;2070;19;114
Norte;PA;2020-04-27;149;2219;8;122
Norte;PA;2020-04-28;100;2319;10;132
Norte;PA;2020-04-29;267;2586;24;156
Norte;PA;2020-04-30;413;2999;68;224
Norte;PA;2020-05-01;360;3359;39;263
Norte;PA;2020-05-02;368;3727;43;306
Norte;PA;2020-05-03;193;3920;11;317
Norte;PA;2020-05-04;342;4262;27;344
Norte;PA;2020-05-05;494;4756;31;375
Norte;PA;2020-05-06;768;5524;35;410
Norte;PA;2020-05-07;411;5935;78;488
Norte;PA;2020-05-08;584;6519;86;574
Norte;PA;2020-05-09;499;7018;36;610
Norte;PA;2020-05-10;330;7348;62;672
Norte;PA;2020-05-11;721;8069;140;812
Norte;PA;2020-05-12;990;9059;102;914
Norte;PA;2020-05-13;1285;10344;108;1022
Norte;PA;2020-05-14;1135;11479;73;1095
Norte;PA;2020-05-15;1147;12626;80;1175
Norte;PA;2020-05-16;838;13464;48;1223
Norte;PA;2020-05-17;737;14201;57;1280
Norte;PA;2020-05-18;1266;15467;112;1392
Norte;PA;2020-05-20;3462;18929;386;1778
Norte;PA;2020-05-21;1603;20532;115;1893
Norte;PA;2020-05-22;2165;22697;110;2003
Norte;PA;2020-05-23;1428;24125;147;2150
Norte;PA;2020-05-24;690;24815;140;2290
Norte;PA;2020-05-25;2551;27366;141;2431
Norte;PA;2020-05-26;2516;29882;91;2522
Norte;PA;2020-05-27;1789;31671;83;2605
Norte;PA;2020-05-28;3461;35132;180;2785
Norte;PA;2020-05-29;2164;37296;115;2900
Norte;PA;2020-05-30;563;37859;20;2920
Norte;PA;2020-05-31;102;37961;3;2923
Norte;PA;2020-06-01;2053;40014;96;3019
Norte;PA;2020-06-02;3638;43652;125;3144
Norte;PA;2020-06-03;2821;46473;101;3245
Norte;PA;2020-06-06;7387;53860;420;3665
Norte;PA;2020-06-07;411;54271;13;3678
Norte;RO;2020-03-20;0;1;0;0
Norte;RO;2020-03-21;2;3;0;0
Norte;RO;2020-03-22;0;3;0;0
Norte;RO;2020-03-24;2;5;0;0
Norte;RO;2020-03-25;0;5;0;0
Norte;RO;2020-03-26;1;6;0;0
Norte;RO;2020-03-27;0;6;0;0
Norte;RO;2020-03-28;0;6;0;0
Norte;RO;2020-03-29;0;6;0;0
Norte;RO;2020-03-30;2;8;1;1
Norte;RO;2020-03-31;1;9;0;1
Norte;RO;2020-04-01;0;9;0;1
Norte;RO;2020-04-02;1;10;0;1
Norte;RO;2020-04-03;0;10;0;1
Norte;RO;2020-04-04;1;11;0;1
Norte;RO;2020-04-05;3;14;0;1
Norte;RO;2020-04-06;4;18;0;1
Norte;RO;2020-04-07;5;23;0;1
Norte;RO;2020-04-08;3;26;0;1
Norte;RO;2020-04-09;2;28;1;2
Norte;RO;2020-04-10;4;32;0;2
Norte;RO;2020-04-11;2;34;0;2
Norte;RO;2020-04-12;8;42;0;2
Norte;RO;2020-04-14;27;69;0;2
Norte;RO;2020-04-15;4;73;0;2
Norte;RO;2020-04-16;19;92;1;3
Norte;RO;2020-04-17;18;110;0;3
Norte;RO;2020-04-18;18;128;1;4
Norte;RO;2020-04-19;32;160;0;4
Norte;RO;2020-04-20;39;199;0;4
Norte;RO;2020-04-21;24;223;1;5
Norte;RO;2020-04-23;27;250;0;5
Norte;RO;2020-04-24;40;290;1;6
Norte;RO;2020-04-25;38;328;1;7
Norte;RO;2020-04-26;36;364;3;10
Norte;RO;2020-04-27;29;393;0;10
Norte;RO;2020-04-28;20;413;1;11
Norte;RO;2020-04-29;20;433;4;15
Norte;RO;2020-04-30;69;502;1;16
Norte;RO;2020-05-01;83;585;2;18
Norte;RO;2020-05-02;69;654;5;23
Norte;RO;2020-05-03;51;705;1;24
Norte;RO;2020-05-04;51;756;1;25
Norte;RO;2020-05-05;105;861;4;29
Norte;RO;2020-05-06;82;943;4;33
Norte;RO;2020-05-07;155;1098;4;37
Norte;RO;2020-05-08;124;1222;2;39
Norte;RO;2020-05-09;41;1263;2;41
Norte;RO;2020-05-10;39;1302;2;43
Norte;RO;2020-05-11;96;1398;4;47
Norte;RO;2020-05-12;62;1460;3;50
Norte;RO;2020-05-13;152;1612;0;50
Norte;RO;2020-05-14;74;1686;6;56
Norte;RO;2020-05-15;108;1794;6;62
Norte;RO;2020-05-16;124;1918;7;69
Norte;RO;2020-05-17;45;1963;5;74
Norte;RO;2020-05-18;80;2043;9;83
Norte;RO;2020-05-19;370;2413;5;88
Norte;RO;2020-05-20;86;2499;2;90
Norte;RO;2020-05-22;275;2774;16;106
Norte;RO;2020-05-23;335;3109;9;115
Norte;RO;2020-05-24;92;3201;6;121
Norte;RO;2020-05-25;67;3268;0;121
Norte;RO;2020-05-26;225;3493;12;133
Norte;RO;2020-05-27;369;3862;4;137
Norte;RO;2020-05-28;390;4252;5;142
Norte;RO;2020-05-29;250;4502;3;145
Norte;RO;2020-05-30;241;4743;6;151
Norte;RO;2020-05-31;199;4942;5;156
Norte;RO;2020-06-02;535;5477;16;172
Norte;RO;2020-06-03;237;5714;8;180
Norte;RO;2020-06-04;745;6459;14;194
Norte;RO;2020-06-05;403;6862;19;213
Norte;RO;2020-06-06;839;7701;15;228
Norte;RO;2020-06-07;409;8110;7;235
Norte;RR;2020-03-21;0;2;0;0
Norte;RR;2020-03-22;0;2;0;0
Norte;RR;2020-03-23;0;2;0;0
Norte;RR;2020-03-24;6;8;0;0
Norte;RR;2020-03-25;0;8;0;0
Norte;RR;2020-03-26;2;10;0;0
Norte;RR;2020-03-27;2;12;0;0
Norte;RR;2020-03-28;4;16;0;0
Norte;RR;2020-03-29;0;16;0;0
Norte;RR;2020-03-30;0;16;0;0
Norte;RR;2020-03-31;0;16;0;0
Norte;RR;2020-04-01;10;26;0;0
Norte;RR;2020-04-02;4;30;0;0
Norte;RR;2020-04-03;7;37;1;1
Norte;RR;2020-04-04;5;42;0;1
Norte;RR;2020-04-05;0;42;0;1
Norte;RR;2020-04-06;0;42;0;1
Norte;RR;2020-04-07;7;49;0;1
Norte;RR;2020-04-08;3;52;0;1
Norte;RR;2020-04-09;11;63;1;2
Norte;RR;2020-04-10;12;75;1;3
Norte;RR;2020-04-11;4;79;0;3
Norte;RR;2020-04-12;4;83;0;3
Norte;RR;2020-04-13;30;113;0;3
Norte;RR;2020-04-14;1;114;0;3
Norte;RR;2020-04-15;28;142;0;3
Norte;RR;2020-04-16;22;164;0;3
Norte;RR;2020-04-17;37;201;0;3
Norte;RR;2020-04-18;21;222;0;3
Norte;RR;2020-04-19;22;244;0;3
Norte;RR;2020-04-20;3;247;0;3
Norte;RR;2020-04-21;33;280;0;3
Norte;RR;2020-04-22;17;297;0;3
Norte;RR;2020-04-23;7;304;0;3
Norte;RR;2020-04-24;41;345;0;3
Norte;RR;2020-04-25;56;401;1;4
Norte;RR;2020-04-26;6;407;0;4
Norte;RR;2020-04-27;18;425;0;4
Norte;RR;2020-04-29;1;426;0;4
Norte;RR;2020-04-30;93;519;3;7
Norte;RR;2020-05-03;14;533;0;7
Norte;RR;2020-05-04;45;578;4;11
Norte;RR;2020-05-05;291;869;0;11
Norte;RR;2020-05-06;63;932;2;13
Norte;RR;2020-05-07;88;1020;1;14
Norte;RR;2020-05-08;104;1124;2;16
Norte;RR;2020-05-09;78;1202;2;18
Norte;RR;2020-05-10;88;1290;3;21
Norte;RR;2020-05-11;5;1295;3;24
Norte;RR;2020-05-12;116;1411;4;28
Norte;RR;2020-05-13;0;1411;1;29
Norte;RR;2020-05-14;89;1500;8;37
Norte;RR;2020-05-15;89;1589;3;40
Norte;RR;2020-05-16;117;1706;9;49
Norte;RR;2020-05-17;85;1791;2;51
Norte;RR;2020-05-18;91;1882;9;60
Norte;RR;2020-05-19;106;1988;4;64
Norte;RR;2020-05-22;308;2296;8;72
Norte;RR;2020-05-23;143;2439;0;72
Norte;RR;2020-05-24;0;2439;12;84
Norte;RR;2020-05-25;125;2564;2;86
Norte;RR;2020-05-26;118;2682;16;102
Norte;RR;2020-05-27;277;2959;0;102
Norte;RR;2020-05-28;139;3098;6;108
Norte;RR;2020-05-29;201;3299;2;110
Norte;RR;2020-05-30;175;3474;6;116
Norte;RR;2020-05-31;218;3692;0;116
Norte;RR;2020-06-01;158;3850;4;120
Norte;RR;2020-06-02;293;4143;4;124
Norte;RR;2020-06-04;688;4831;15;139
Norte;RR;2020-06-05;407;5238;0;139
Norte;RR;2020-06-07;291;5529;3;142
Norte;TO;2020-03-18;0;1;0;0
Norte;TO;2020-03-19;0;1;0;0
Norte;TO;2020-03-20;0;1;0;0
Norte;TO;2020-03-21;1;2;0;0
Norte;TO;2020-03-22;3;5;0;0
Norte;TO;2020-03-23;2;7;0;0
Norte;TO;2020-03-24;0;7;0;0
Norte;TO;2020-03-25;0;7;0;0
Norte;TO;2020-03-26;1;8;0;0
Norte;TO;2020-03-27;1;9;0;0
Norte;TO;2020-03-28;0;9;0;0
Norte;TO;2020-03-29;1;10;0;0
Norte;TO;2020-03-30;1;11;0;0
Norte;TO;2020-03-31;1;12;0;0
Norte;TO;2020-04-01;0;12;0;0
Norte;TO;2020-04-02;0;12;0;0
Norte;TO;2020-04-03;1;13;0;0
Norte;TO;2020-04-04;3;16;0;0
Norte;TO;2020-04-05;1;17;0;0
Norte;TO;2020-04-06;2;19;0;0
Norte;TO;2020-04-07;0;19;0;0
Norte;TO;2020-04-08;4;23;0;0
Norte;TO;2020-04-09;0;23;0;0
Norte;TO;2020-04-10;0;23;0;0
Norte;TO;2020-04-11;2;25;0;0
Norte;TO;2020-04-12;1;26;0;0
Norte;TO;2020-04-13;0;26;0;0
Norte;TO;2020-04-14;1;27;0;0
Norte;TO;2020-04-15;2;29;1;1
Norte;TO;2020-04-16;2;31;0;1
Norte;TO;2020-04-17;1;32;0;1
Norte;TO;2020-04-18;1;33;0;1
Norte;TO;2020-04-19;1;34;0;1
Norte;TO;2020-04-20;1;35;1;2
Norte;TO;2020-04-21;1;36;0;2
Norte;TO;2020-04-22;1;37;0;2
Norte;TO;2020-04-23;6;43;0;2
Norte;TO;2020-04-24;7;50;0;2
Norte;TO;2020-04-25;8;58;0;2
Norte;TO;2020-04-26;9;67;0;2
Norte;TO;2020-04-27;12;79;0;2
Norte;TO;2020-04-28;37;116;0;2
Norte;TO;2020-04-29;21;137;1;3
Norte;TO;2020-04-30;27;164;0;3
Norte;TO;2020-05-01;27;191;1;4
Norte;TO;2020-05-02;55;246;0;4
Norte;TO;2020-05-03;21;267;2;6
Norte;TO;2020-05-04;36;303;1;7
Norte;TO;2020-05-05;48;351;2;9
Norte;TO;2020-05-06;72;423;0;9
Norte;TO;2020-05-07;71;494;0;9
Norte;TO;2020-05-08;78;572;0;9
Norte;TO;2020-05-09;116;688;2;11
Norte;TO;2020-05-10;59;747;1;12
Norte;TO;2020-05-11;81;828;2;14
Norte;TO;2020-05-12;104;932;7;21
Norte;TO;2020-05-13;97;1029;2;23
Norte;TO;2020-05-14;150;1179;1;24
Norte;TO;2020-05-15;100;1279;3;27
Norte;TO;2020-05-17;217;1496;5;32
Norte;TO;2020-05-18;150;1646;6;38
Norte;TO;2020-05-19;163;1809;4;42
Norte;TO;2020-05-20;167;1976;5;47
Norte;TO;2020-05-21;229;2205;2;49
Norte;TO;2020-05-22;225;2430;2;51
Norte;TO;2020-05-25;266;2696;7;58
Norte;TO;2020-05-26;162;2858;6;64
Norte;TO;2020-05-28;419;3277;4;68
Norte;TO;2020-05-29;334;3611;2;70
Norte;TO;2020-05-30;370;3981;1;71
Norte;TO;2020-05-31;195;4176;2;73
Norte;TO;2020-06-01;169;4345;3;76
Norte;TO;2020-06-02;138;4483;3;79
Norte;TO;2020-06-03;215;4698;3;82
Norte;TO;2020-06-05;807;5505;14;96
Norte;TO;2020-06-06;139;5644;3;99
Norte;TO;2020-06-07;0;5644;0;99
Sudeste;ES;2020-03-05;0;1;0;0
Sudeste;ES;2020-03-06;0;1;0;0
Sudeste;ES;2020-03-07;0;1;0;0
Sudeste;ES;2020-03-08;0;1;0;0
Sudeste;ES;2020-03-09;0;1;0;0
Sudeste;ES;2020-03-10;0;1;0;0
Sudeste;ES;2020-03-11;0;1;0;0
Sudeste;ES;2020-03-12;1;2;0;0
Sudeste;ES;2020-03-13;0;2;0;0
Sudeste;ES;2020-03-14;2;4;0;0
Sudeste;ES;2020-03-15;0;4;0;0
Sudeste;ES;2020-03-16;4;8;0;0
Sudeste;ES;2020-03-17;0;8;0;0
Sudeste;ES;2020-03-18;3;11;0;0
Sudeste;ES;2020-03-19;2;13;0;0
Sudeste;ES;2020-03-20;3;16;0;0
Sudeste;ES;2020-03-21;10;26;0;0
Sudeste;ES;2020-03-22;0;26;0;0
Sudeste;ES;2020-03-23;7;33;0;0
Sudeste;ES;2020-03-24;7;40;0;0
Sudeste;ES;2020-03-25;0;40;0;0
Sudeste;ES;2020-03-26;8;48;0;0
Sudeste;ES;2020-03-27;6;54;0;0
Sudeste;ES;2020-03-28;7;61;0;0
Sudeste;ES;2020-03-29;11;72;0;0
Sudeste;ES;2020-03-30;13;85;0;0
Sudeste;ES;2020-03-31;12;97;0;0
Sudeste;ES;2020-04-01;23;120;0;0
Sudeste;ES;2020-04-02;19;139;2;2
Sudeste;ES;2020-04-03;14;153;3;5
Sudeste;ES;2020-04-04;13;166;1;6
Sudeste;ES;2020-04-05;28;194;0;6
Sudeste;ES;2020-04-06;15;209;0;6
Sudeste;ES;2020-04-07;18;227;0;6
Sudeste;ES;2020-04-08;46;273;0;6
Sudeste;ES;2020-04-09;27;300;1;7
Sudeste;ES;2020-04-10;49;349;1;8
Sudeste;ES;2020-04-11;34;383;1;9
Sudeste;ES;2020-04-12;47;430;5;14
Sudeste;ES;2020-04-13;33;463;3;17
Sudeste;ES;2020-04-14;94;557;1;18
Sudeste;ES;2020-04-15;177;734;3;21
Sudeste;ES;2020-04-16;201;935;7;28
Sudeste;ES;2020-04-17;17;952;0;28
Sudeste;ES;2020-04-18;147;1099;2;30
Sudeste;ES;2020-04-19;96;1195;4;34
Sudeste;ES;2020-04-20;17;1212;0;34
Sudeste;ES;2020-04-21;101;1313;0;34
Sudeste;ES;2020-04-22;38;1351;3;37
Sudeste;ES;2020-04-23;102;1453;6;43
Sudeste;ES;2020-04-24;212;1665;4;47
Sudeste;ES;2020-04-25;46;1711;5;52
Sudeste;ES;2020-04-26;108;1819;5;57
Sudeste;ES;2020-04-27;125;1944;6;63
Sudeste;ES;2020-04-28;220;2164;14;77
Sudeste;ES;2020-04-29;374;2538;7;84
Sudeste;ES;2020-04-30;150;2688;9;93
Sudeste;ES;2020-05-01;225;2913;8;101
Sudeste;ES;2020-05-02;191;3104;3;104
Sudeste;ES;2020-05-03;104;3208;11;115
Sudeste;ES;2020-05-04;143;3351;8;123
Sudeste;ES;2020-05-05;189;3540;10;133
Sudeste;ES;2020-05-06;174;3714;13;146
Sudeste;ES;2020-05-07;274;3988;11;157
Sudeste;ES;2020-05-08;254;4242;8;165
Sudeste;ES;2020-05-09;170;4412;7;172
Sudeste;ES;2020-05-10;187;4599;9;181
Sudeste;ES;2020-05-11;220;4819;15;196
Sudeste;ES;2020-05-12;268;5087;16;212
Sudeste;ES;2020-05-13;314;5401;21;233
Sudeste;ES;2020-05-14;412;5813;16;249
Sudeste;ES;2020-05-15;385;6198;11;260
Sudeste;ES;2020-05-16;397;6595;11;271
Sudeste;ES;2020-05-17;149;6744;14;285
Sudeste;ES;2020-05-18;413;7157;17;302
Sudeste;ES;2020-05-19;536;7693;23;325
Sudeste;ES;2020-05-20;802;8495;21;346
Sudeste;ES;2020-05-21;383;8878;17;363
Sudeste;ES;2020-05-22;642;9520;34;397
Sudeste;ES;2020-05-23;398;9918;20;417
Sudeste;ES;2020-05-24;89;10007;30;447
Sudeste;ES;2020-05-25;358;10365;18;465
Sudeste;ES;2020-05-26;524;10889;22;487
Sudeste;ES;2020-05-27;595;11484;24;511
Sudeste;ES;2020-05-28;719;12203;27;538
Sudeste;ES;2020-05-29;700;12903;22;560
Sudeste;ES;2020-05-30;534;13437;23;583
Sudeste;ES;2020-05-31;253;13690;21;604
Sudeste;ES;2020-06-01;595;14285;24;628
Sudeste;ES;2020-06-02;866;15151;36;664
Sudeste;ES;2020-06-03;970;16121;34;698
Sudeste;ES;2020-06-04;773;16894;39;737
Sudeste;ES;2020-06-05;1215;18109;43;780
Sudeste;ES;2020-06-06;841;18950;26;806
Sudeste;ES;2020-06-07;669;19619;26;832
Sudeste;MG;2020-03-08;0;1;0;0
Sudeste;MG;2020-03-09;0;1;0;0
Sudeste;MG;2020-03-10;0;1;0;0
Sudeste;MG;2020-03-11;0;1;0;0
Sudeste;MG;2020-03-12;1;2;0;0
Sudeste;MG;2020-03-13;0;2;0;0
Sudeste;MG;2020-03-14;2;4;0;0
Sudeste;MG;2020-03-16;2;6;0;0
Sudeste;MG;2020-03-17;8;14;0;0
Sudeste;MG;2020-03-18;5;19;0;0
Sudeste;MG;2020-03-19;10;29;0;0
Sudeste;MG;2020-03-20;9;38;0;0
Sudeste;MG;2020-03-21;17;55;0;0
Sudeste;MG;2020-03-22;28;83;0;0
Sudeste;MG;2020-03-23;45;128;0;0
Sudeste;MG;2020-03-24;2;130;0;0
Sudeste;MG;2020-03-25;3;133;0;0
Sudeste;MG;2020-03-26;20;153;0;0
Sudeste;MG;2020-03-27;36;189;0;0
Sudeste;MG;2020-03-28;16;205;0;0
Sudeste;MG;2020-03-29;26;231;0;0
Sudeste;MG;2020-03-30;30;261;1;1
Sudeste;MG;2020-03-31;14;275;1;2
Sudeste;MG;2020-04-01;39;314;1;3
Sudeste;MG;2020-04-02;56;370;1;4
Sudeste;MG;2020-04-03;27;397;2;6
Sudeste;MG;2020-04-04;33;430;0;6
Sudeste;MG;2020-04-05;68;498;0;6
Sudeste;MG;2020-04-06;27;525;3;9
Sudeste;MG;2020-04-07;34;559;2;11
Sudeste;MG;2020-04-08;55;614;3;14
Sudeste;MG;2020-04-09;41;655;1;15
Sudeste;MG;2020-04-10;43;698;2;17
Sudeste;MG;2020-04-11;52;750;0;17
Sudeste;MG;2020-04-12;56;806;3;20
Sudeste;MG;2020-04-13;9;815;3;23
Sudeste;MG;2020-04-14;69;884;4;27
Sudeste;MG;2020-04-15;19;903;3;30
Sudeste;MG;2020-04-16;55;958;3;33
Sudeste;MG;2020-04-17;63;1021;2;35
Sudeste;MG;2020-04-18;56;1077;4;39
Sudeste;MG;2020-04-19;77;1154;0;39
Sudeste;MG;2020-04-20;35;1189;2;41
Sudeste;MG;2020-04-21;41;1230;3;44
Sudeste;MG;2020-04-22;53;1283;3;47
Sudeste;MG;2020-04-23;25;1308;4;51
Sudeste;MG;2020-04-24;111;1419;3;54
Sudeste;MG;2020-04-25;62;1481;4;58
Sudeste;MG;2020-04-26;67;1548;3;61
Sudeste;MG;2020-04-27;38;1586;1;62
Sudeste;MG;2020-04-28;63;1649;9;71
Sudeste;MG;2020-04-29;109;1758;9;80
Sudeste;MG;2020-04-30;69;1827;2;82
Sudeste;MG;2020-05-01;108;1935;6;88
Sudeste;MG;2020-05-02;88;2023;0;88
Sudeste;MG;2020-05-03;95;2118;1;89
Sudeste;MG;2020-05-04;229;2347;1;90
Sudeste;MG;2020-05-05;105;2452;4;94
Sudeste;MG;2020-05-06;153;2605;3;97
Sudeste;MG;2020-05-07;165;2770;9;106
Sudeste;MG;2020-05-08;173;2943;5;111
Sudeste;MG;2020-05-09;180;3123;7;118
Sudeste;MG;2020-05-10;114;3237;1;119
Sudeste;MG;2020-05-11;83;3320;2;121
Sudeste;MG;2020-05-12;115;3435;6;127
Sudeste;MG;2020-05-13;298;3733;8;135
Sudeste;MG;2020-05-14;217;3950;4;139
Sudeste;MG;2020-05-15;246;4196;7;146
Sudeste;MG;2020-05-16;278;4474;4;150
Sudeste;MG;2020-05-17;137;4611;6;156
Sudeste;MG;2020-05-18;84;4695;5;161
Sudeste;MG;2020-05-19;282;4977;6;167
Sudeste;MG;2020-05-20;309;5286;10;177
Sudeste;MG;2020-05-21;310;5596;14;191
Sudeste;MG;2020-05-22;399;5995;10;201
Sudeste;MG;2020-05-23;343;6338;16;217
Sudeste;MG;2020-05-24;330;6668;9;226
Sudeste;MG;2020-05-25;294;6962;4;230
Sudeste;MG;2020-05-26;554;7516;4;234
Sudeste;MG;2020-05-27;495;8011;6;240
Sudeste;MG;2020-05-28;675;8686;15;255
Sudeste;MG;2020-05-29;546;9232;2;257
Sudeste;MG;2020-05-30;398;9630;6;263
Sudeste;MG;2020-05-31;834;10464;8;271
Sudeste;MG;2020-06-01;206;10670;7;278
Sudeste;MG;2020-06-02;269;10939;11;289
Sudeste;MG;2020-06-03;1071;12010;17;306
Sudeste;MG;2020-06-04;1024;13034;17;323
Sudeste;MG;2020-06-05;961;13995;21;344
Sudeste;MG;2020-06-06;944;14939;24;368
Sudeste;MG;2020-06-07;764;15703;8;376
Sudeste;RJ;2020-03-05;0;1;0;0
Sudeste;RJ;2020-03-06;1;2;0;0
Sudeste;RJ;2020-03-08;1;3;0;0
Sudeste;RJ;2020-03-12;12;15;0;0
Sudeste;RJ;2020-03-15;9;24;0;0
Sudeste;RJ;2020-03-16;1;25;0;0
Sudeste;RJ;2020-03-18;38;63;0;0
Sudeste;RJ;2020-03-19;3;66;2;2
Sudeste;RJ;2020-03-21;53;119;1;3
Sudeste;RJ;2020-03-22;67;186;0;3
Sudeste;RJ;2020-03-23;47;233;1;4
Sudeste;RJ;2020-03-24;72;305;2;6
Sudeste;RJ;2020-03-25;65;370;2;8
Sudeste;RJ;2020-03-26;51;421;1;9
Sudeste;RJ;2020-03-27;72;493;1;10
Sudeste;RJ;2020-03-28;65;558;3;13
Sudeste;RJ;2020-03-29;42;600;4;17
Sudeste;RJ;2020-03-30;57;657;1;18
Sudeste;RJ;2020-03-31;51;708;5;23
Sudeste;RJ;2020-04-01;124;832;5;28
Sudeste;RJ;2020-04-02;160;992;13;41
Sudeste;RJ;2020-04-03;82;1074;6;47
Sudeste;RJ;2020-04-04;172;1246;11;58
Sudeste;RJ;2020-04-05;148;1394;6;64
Sudeste;RJ;2020-04-06;67;1461;7;71
Sudeste;RJ;2020-04-07;227;1688;18;89
Sudeste;RJ;2020-04-08;250;1938;17;106
Sudeste;RJ;2020-04-09;278;2216;16;122
Sudeste;RJ;2020-04-10;248;2464;25;147
Sudeste;RJ;2020-04-11;143;2607;8;155
Sudeste;RJ;2020-04-12;248;2855;15;170
Sudeste;RJ;2020-04-13;366;3221;12;182
Sudeste;RJ;2020-04-14;189;3410;42;224
Sudeste;RJ;2020-04-15;333;3743;41;265
Sudeste;RJ;2020-04-16;201;3944;36;301
Sudeste;RJ;2020-04-17;405;4349;40;341
Sudeste;RJ;2020-04-18;194;4543;46;387
Sudeste;RJ;2020-04-19;132;4675;15;402
Sudeste;RJ;2020-04-20;224;4899;20;422
Sudeste;RJ;2020-04-21;407;5306;39;461
Sudeste;RJ;2020-04-22;246;5552;29;490
Sudeste;RJ;2020-04-23;620;6172;40;530
Sudeste;RJ;2020-04-24;110;6282;40;570
Sudeste;RJ;2020-04-25;546;6828;45;615
Sudeste;RJ;2020-04-26;283;7111;30;645
Sudeste;RJ;2020-04-27;833;7944;32;677
Sudeste;RJ;2020-04-28;560;8504;61;738
Sudeste;RJ;2020-04-29;365;8869;56;794
Sudeste;RJ;2020-04-30;584;9453;60;854
Sudeste;RJ;2020-05-01;713;10166;67;921
Sudeste;RJ;2020-05-02;380;10546;50;971
Sudeste;RJ;2020-05-03;593;11139;48;1019
Sudeste;RJ;2020-05-04;582;11721;46;1065
Sudeste;RJ;2020-05-05;670;12391;58;1123
Sudeste;RJ;2020-05-06;904;13295;82;1205
Sudeste;RJ;2020-05-07;861;14156;189;1394
Sudeste;RJ;2020-05-08;1585;15741;109;1503
Sudeste;RJ;2020-05-09;1188;16929;150;1653
Sudeste;RJ;2020-05-10;133;17062;61;1714
Sudeste;RJ;2020-05-11;877;17939;56;1770
Sudeste;RJ;2020-05-12;547;18486;158;1928
Sudeste;RJ;2020-05-13;242;18728;122;2050
Sudeste;RJ;2020-05-14;739;19467;197;2247
Sudeste;RJ;2020-05-15;520;19987;191;2438
Sudeste;RJ;2020-05-16;1614;21601;176;2614
Sudeste;RJ;2020-05-17;637;22238;101;2715
Sudeste;RJ;2020-05-18;4427;26665;137;2852
Sudeste;RJ;2020-05-19;1140;27805;227;3079
Sudeste;RJ;2020-05-20;2567;30372;158;3237
Sudeste;RJ;2020-05-21;1717;32089;175;3412
Sudeste;RJ;2020-05-22;1500;33589;245;3657
Sudeste;RJ;2020-05-23;944;34533;248;3905
Sudeste;RJ;2020-05-24;3379;37912;88;3993
Sudeste;RJ;2020-05-25;1386;39298;112;4105
Sudeste;RJ;2020-05-26;726;40024;256;4361
Sudeste;RJ;2020-05-27;2374;42398;244;4605
Sudeste;RJ;2020-05-28;2488;44886;251;4856
Sudeste;RJ;2020-05-29;3067;47953;223;5079
Sudeste;RJ;2020-05-30;4467;52420;198;5277
Sudeste;RJ;2020-05-31;968;53388;67;5344
Sudeste;RJ;2020-06-01;1142;54530;118;5462
Sudeste;RJ;2020-06-02;2202;56732;224;5686
Sudeste;RJ;2020-06-03;2508;59240;324;6010
Sudeste;RJ;2020-06-04;1692;60932;317;6327
Sudeste;RJ;2020-06-05;2134;63066;146;6473
Sudeste;RJ;2020-06-06;1467;64533;166;6639
Sudeste;RJ;2020-06-07;3223;67756;68;6707
Sudeste;SP;2020-02-25;0;1;0;0
Sudeste;SP;2020-02-26;0;1;0;0
Sudeste;SP;2020-02-27;0;1;0;0
Sudeste;SP;2020-02-28;1;2;0;0
Sudeste;SP;2020-02-29;0;2;0;0
Sudeste;SP;2020-03-01;0;2;0;0
Sudeste;SP;2020-03-02;0;2;0;0
Sudeste;SP;2020-03-03;0;2;0;0
Sudeste;SP;2020-03-04;1;3;0;0
Sudeste;SP;2020-03-05;3;6;0;0
Sudeste;SP;2020-03-06;4;10;0;0
Sudeste;SP;2020-03-07;3;13;0;0
Sudeste;SP;2020-03-08;3;16;0;0
Sudeste;SP;2020-03-09;0;16;0;0
Sudeste;SP;2020-03-10;3;19;0;0
Sudeste;SP;2020-03-11;11;30;0;0
Sudeste;SP;2020-03-12;16;46;0;0
Sudeste;SP;2020-03-14;19;65;0;0
Sudeste;SP;2020-03-16;87;152;0;0
Sudeste;SP;2020-03-17;12;164;1;1
Sudeste;SP;2020-03-18;76;240;2;3
Sudeste;SP;2020-03-19;46;286;2;5
Sudeste;SP;2020-03-20;110;396;4;9
Sudeste;SP;2020-03-21;0;396;6;15
Sudeste;SP;2020-03-22;235;631;7;22
Sudeste;SP;2020-03-23;114;745;8;30
Sudeste;SP;2020-03-24;65;810;10;40
Sudeste;SP;2020-03-25;52;862;8;48
Sudeste;SP;2020-03-26;190;1052;10;58
Sudeste;SP;2020-03-27;171;1223;10;68
Sudeste;SP;2020-03-28;183;1406;16;84
Sudeste;SP;2020-03-29;45;1451;14;98
Sudeste;SP;2020-03-30;66;1517;15;113
Sudeste;SP;2020-03-31;822;2339;23;136
Sudeste;SP;2020-04-01;642;2981;28;164
Sudeste;SP;2020-04-02;525;3506;24;188
Sudeste;SP;2020-04-03;542;4048;31;219
Sudeste;SP;2020-04-04;418;4466;41;260
Sudeste;SP;2020-04-05;154;4620;15;275
Sudeste;SP;2020-04-06;246;4866;29;304
Sudeste;SP;2020-04-07;816;5682;67;371
Sudeste;SP;2020-04-08;1026;6708;57;428
Sudeste;SP;2020-04-09;772;7480;68;496
Sudeste;SP;2020-04-10;736;8216;44;540
Sudeste;SP;2020-04-11;203;8419;20;560
Sudeste;SP;2020-04-12;336;8755;28;588
Sudeste;SP;2020-04-13;140;8895;20;608
Sudeste;SP;2020-04-14;476;9371;87;695
Sudeste;SP;2020-04-15;1672;11043;83;778
Sudeste;SP;2020-04-16;525;11568;75;853
Sudeste;SP;2020-04-17;1273;12841;75;928
Sudeste;SP;2020-04-18;1053;13894;63;991
Sudeste;SP;2020-04-19;373;14267;24;1015
Sudeste;SP;2020-04-20;313;14580;22;1037
Sudeste;SP;2020-04-21;805;15385;56;1093
Sudeste;SP;2020-04-22;529;15914;41;1134
Sudeste;SP;2020-04-23;826;16740;211;1345
Sudeste;SP;2020-04-24;1086;17826;167;1512
Sudeste;SP;2020-04-25;2178;20004;155;1667
Sudeste;SP;2020-04-26;711;20715;33;1700
Sudeste;SP;2020-04-27;981;21696;125;1825
Sudeste;SP;2020-04-28;2345;24041;224;2049
Sudeste;SP;2020-04-29;2117;26158;198;2247
Sudeste;SP;2020-04-30;2540;28698;128;2375
Sudeste;SP;2020-05-01;1676;30374;136;2511
Sudeste;SP;2020-05-02;800;31174;75;2586
Sudeste;SP;2020-05-03;598;31772;41;2627
Sudeste;SP;2020-05-04;415;32187;27;2654
Sudeste;SP;2020-05-05;1866;34053;197;2851
Sudeste;SP;2020-05-06;3800;37853;194;3045
Sudeste;SP;2020-05-07;2075;39928;161;3206
Sudeste;SP;2020-05-08;1902;41830;210;3416
Sudeste;SP;2020-05-09;2581;44411;192;3608
Sudeste;SP;2020-05-10;1033;45444;101;3709
Sudeste;SP;2020-05-11;687;46131;34;3743
Sudeste;SP;2020-05-12;1588;47719;206;3949
Sudeste;SP;2020-05-13;3378;51097;169;4118
Sudeste;SP;2020-05-14;3189;54286;197;4315
Sudeste;SP;2020-05-15;4092;58378;186;4501
Sudeste;SP;2020-05-16;2805;61183;187;4688
Sudeste;SP;2020-05-17;1162;62345;94;4782
Sudeste;SP;2020-05-18;721;63066;41;4823
Sudeste;SP;2020-05-19;2929;65995;324;5147
Sudeste;SP;2020-05-20;3864;69859;216;5363
Sudeste;SP;2020-05-21;3880;73739;195;5558
Sudeste;SP;2020-05-22;3132;76871;215;5773
Sudeste;SP;2020-05-23;3687;80558;272;6045
Sudeste;SP;2020-05-24;1603;82161;118;6163
Sudeste;SP;2020-05-25;1464;83625;57;6220
Sudeste;SP;2020-05-26;2392;86017;203;6423
Sudeste;SP;2020-05-27;3466;89483;289;6712
Sudeste;SP;2020-05-28;6382;95865;268;6980
Sudeste;SP;2020-05-29;5691;101556;295;7275
Sudeste;SP;2020-05-30;5586;107142;257;7532
Sudeste;SP;2020-05-31;2556;109698;83;7615
Sudeste;SP;2020-06-01;1598;111296;52;7667
Sudeste;SP;2020-06-02;6999;118295;327;7994
Sudeste;SP;2020-06-03;5188;123483;282;8276
Sudeste;SP;2020-06-04;5717;129200;285;8561
Sudeste;SP;2020-06-05;5365;134565;281;8842
Sudeste;SP;2020-06-06;5984;140549;216;9058
Sudeste;SP;2020-06-07;2524;143073;87;9145
Sul;PR;2020-03-12;0;6;0;0
Sul;PR;2020-03-13;0;6;0;0
Sul;PR;2020-03-16;0;6;0;0
Sul;PR;2020-03-17;6;12;0;0
Sul;PR;2020-03-18;2;14;0;0
Sul;PR;2020-03-19;9;23;0;0
Sul;PR;2020-03-20;13;36;0;0
Sul;PR;2020-03-21;7;43;0;0
Sul;PR;2020-03-22;11;54;0;0
Sul;PR;2020-03-23;6;60;0;0
Sul;PR;2020-03-24;10;70;0;0
Sul;PR;2020-03-25;27;97;0;0
Sul;PR;2020-03-26;9;106;0;0
Sul;PR;2020-03-27;19;125;2;2
Sul;PR;2020-03-28;12;137;0;2
Sul;PR;2020-03-29;15;152;0;2
Sul;PR;2020-03-30;8;160;1;3
Sul;PR;2020-03-31;25;185;0;3
Sul;PR;2020-04-01;44;229;0;3
Sul;PR;2020-04-02;29;258;1;4
Sul;PR;2020-04-03;49;307;1;5
Sul;PR;2020-04-04;94;401;2;7
Sul;PR;2020-04-05;44;445;3;10
Sul;PR;2020-04-06;21;466;4;14
Sul;PR;2020-04-07;45;511;1;15
Sul;PR;2020-04-08;39;550;2;17
Sul;PR;2020-04-09;71;621;7;24
Sul;PR;2020-04-10;34;655;2;26
Sul;PR;2020-04-11;33;688;1;27
Sul;PR;2020-04-12;62;750;4;31
Sul;PR;2020-04-13;18;768;2;33
Sul;PR;2020-04-14;35;803;6;39
Sul;PR;2020-04-15;13;816;2;41
Sul;PR;2020-04-16;29;845;2;43
Sul;PR;2020-04-17;42;887;1;44
Sul;PR;2020-04-18;73;960;5;49
Sul;PR;2020-04-19;42;1002;3;52
Sul;PR;2020-04-20;20;1022;1;53
Sul;PR;2020-04-21;17;1039;2;55
Sul;PR;2020-04-22;38;1077;5;60
Sul;PR;2020-04-23;19;1096;2;62
Sul;PR;2020-04-24;37;1133;5;67
Sul;PR;2020-04-25;22;1155;4;71
Sul;PR;2020-04-26;16;1171;4;75
Sul;PR;2020-04-27;30;1201;2;77
Sul;PR;2020-04-28;85;1286;2;79
Sul;PR;2020-04-29;78;1364;5;84
Sul;PR;2020-04-30;59;1423;4;88
Sul;PR;2020-05-01;41;1464;4;92
Sul;PR;2020-05-02;46;1510;1;93
Sul;PR;2020-05-03;23;1533;3;96
Sul;PR;2020-05-04;48;1581;1;97
Sul;PR;2020-05-05;27;1608;5;102
Sul;PR;2020-05-06;39;1647;2;104
Sul;PR;2020-05-07;31;1678;3;107
Sul;PR;2020-05-08;56;1734;2;109
Sul;PR;2020-05-09;75;1809;1;110
Sul;PR;2020-05-10;50;1859;2;112
Sul;PR;2020-05-11;14;1873;2;114
Sul;PR;2020-05-12;57;1930;2;116
Sul;PR;2020-05-13;93;2023;4;120
Sul;PR;2020-05-14;68;2091;2;122
Sul;PR;2020-05-15;76;2167;2;124
Sul;PR;2020-05-16;105;2272;2;126
Sul;PR;2020-05-17;44;2316;1;127
Sul;PR;2020-05-18;74;2390;3;130
Sul;PR;2020-05-19;129;2519;3;133
Sul;PR;2020-05-20;137;2656;7;140
Sul;PR;2020-05-21;199;2855;4;144
Sul;PR;2020-05-22;130;2985;5;149
Sul;PR;2020-05-23;162;3147;4;153
Sul;PR;2020-05-24;113;3260;3;156
Sul;PR;2020-05-25;124;3384;4;160
Sul;PR;2020-05-26;183;3567;4;164
Sul;PR;2020-05-27;201;3768;3;167
Sul;PR;2020-05-28;273;4041;7;174
Sul;PR;2020-05-29;259;4300;4;178
Sul;PR;2020-05-30;238;4538;8;186
Sul;PR;2020-05-31;214;4752;1;187
Sul;PR;2020-06-01;148;4900;8;195
Sul;PR;2020-06-02;335;5235;9;204
Sul;PR;2020-06-03;332;5567;6;210
Sul;PR;2020-06-04;328;5895;10;220
Sul;PR;2020-06-06;709;6604;12;232
Sul;PR;2020-06-07;293;6897;5;237
Sul;RS;2020-03-10;0;1;0;0
Sul;RS;2020-03-11;1;2;0;0
Sul;RS;2020-03-12;2;4;0;0
Sul;RS;2020-03-13;0;4;0;0
Sul;RS;2020-03-16;4;8;0;0
Sul;RS;2020-03-18;11;19;0;0
Sul;RS;2020-03-19;12;31;0;0
Sul;RS;2020-03-20;12;43;0;0
Sul;RS;2020-03-21;26;69;0;0
Sul;RS;2020-03-22;8;77;0;0
Sul;RS;2020-03-23;19;96;0;0
Sul;RS;2020-03-24;16;112;0;0
Sul;RS;2020-03-25;50;162;1;1
Sul;RS;2020-03-26;28;190;0;1
Sul;RS;2020-03-27;7;197;1;2
Sul;RS;2020-03-28;3;200;0;2
Sul;RS;2020-03-29;30;230;0;2
Sul;RS;2020-03-30;24;254;2;4
Sul;RS;2020-03-31;51;305;0;4
Sul;RS;2020-04-01;11;316;1;5
Sul;RS;2020-04-02;70;386;0;5
Sul;RS;2020-04-03;24;410;1;6
Sul;RS;2020-04-04;8;418;1;7
Sul;RS;2020-04-05;50;468;0;7
Sul;RS;2020-04-06;33;501;1;8
Sul;RS;2020-04-07;54;555;0;8
Sul;RS;2020-04-08;26;581;2;10
Sul;RS;2020-04-09;55;636;4;14
Sul;RS;2020-04-10;4;640;1;15
Sul;RS;2020-04-11;13;653;1;16
Sul;RS;2020-04-12;11;664;0;16
Sul;RS;2020-04-13;21;685;1;17
Sul;RS;2020-04-14;35;720;1;18
Sul;RS;2020-04-15;42;762;1;19
Sul;RS;2020-04-16;30;792;2;21
Sul;RS;2020-04-17;39;831;3;24
Sul;RS;2020-04-18;23;854;0;24
Sul;RS;2020-04-19;15;869;2;26
Sul;RS;2020-04-20;35;904;1;27
Sul;RS;2020-04-21;14;918;0;27
Sul;RS;2020-04-22;52;970;1;28
Sul;RS;2020-04-23;69;1039;1;29
Sul;RS;2020-04-24;57;1096;5;34
Sul;RS;2020-04-25;70;1166;1;35
Sul;RS;2020-04-26;42;1208;3;38
Sul;RS;2020-04-27;48;1256;7;45
Sul;RS;2020-04-28;94;1350;4;49
Sul;RS;2020-04-29;70;1420;2;51
Sul;RS;2020-04-30;109;1529;7;58
Sul;RS;2020-05-01;90;1619;4;62
Sul;RS;2020-05-02;47;1666;3;65
Sul;RS;2020-05-03;24;1690;2;67
Sul;RS;2020-05-04;78;1768;9;76
Sul;RS;2020-05-05;251;2019;7;83
Sul;RS;2020-05-06;81;2100;7;90
Sul;RS;2020-05-07;82;2182;1;91
Sul;RS;2020-05-08;311;2493;4;95
Sul;RS;2020-05-09;49;2542;2;97
Sul;RS;2020-05-10;34;2576;3;100
Sul;RS;2020-05-11;232;2808;5;105
Sul;RS;2020-05-12;109;2917;6;111
Sul;RS;2020-05-13;80;2997;9;120
Sul;RS;2020-05-14;104;3101;6;126
Sul;RS;2020-05-15;594;3695;6;132
Sul;RS;2020-05-16;39;3734;6;138
Sul;RS;2020-05-17;1;3735;6;144
Sul;RS;2020-05-18;15;3750;7;151
Sul;RS;2020-05-19;48;3798;9;160
Sul;RS;2020-05-20;1175;4973;1;161
Sul;RS;2020-05-21;500;5473;5;166
Sul;RS;2020-05-22;445;5918;6;172
Sul;RS;2020-05-23;418;6336;4;176
Sul;RS;2020-05-24;134;6470;4;180
Sul;RS;2020-05-25;89;6559;17;197
Sul;RS;2020-05-26;226;6785;6;203
Sul;RS;2020-05-27;263;7048;6;209
Sul;RS;2020-05-28;1186;8234;4;213
Sul;RS;2020-05-29;609;8843;3;216
Sul;RS;2020-05-30;399;9242;2;218
Sul;RS;2020-05-31;90;9332;6;224
Sul;RS;2020-06-01;164;9496;8;232
Sul;RS;2020-06-02;423;9919;13;245
Sul;RS;2020-06-03;479;10398;13;258
Sul;RS;2020-06-04;612;11010;7;265
Sul;RS;2020-06-05;573;11583;11;276
Sul;RS;2020-06-06;454;12037;7;283
Sul;RS;2020-06-07;98;12135;3;286
Sul;SC;2020-03-12;0;2;0;0
Sul;SC;2020-03-13;1;3;0;0
Sul;SC;2020-03-14;2;5;0;0
Sul;SC;2020-03-15;1;6;0;0
Sul;SC;2020-03-16;1;7;0;0
Sul;SC;2020-03-17;0;7;0;0
Sul;SC;2020-03-18;7;14;0;0
Sul;SC;2020-03-19;7;21;0;0
Sul;SC;2020-03-20;19;40;0;0
Sul;SC;2020-03-21;17;57;0;0
Sul;SC;2020-03-22;11;68;0;0
Sul;SC;2020-03-23;18;86;0;0
Sul;SC;2020-03-24;23;109;0;0
Sul;SC;2020-03-25;13;122;0;0
Sul;SC;2020-03-26;27;149;1;1
Sul;SC;2020-03-27;14;163;0;1
Sul;SC;2020-03-28;21;184;0;1
Sul;SC;2020-03-29;13;197;0;1
Sul;SC;2020-03-30;22;219;1;2
Sul;SC;2020-03-31;16;235;0;2
Sul;SC;2020-04-01;12;247;0;2
Sul;SC;2020-04-02;34;281;3;5
Sul;SC;2020-04-03;20;301;0;5
Sul;SC;2020-04-04;55;356;5;10
Sul;SC;2020-04-05;23;379;0;10
Sul;SC;2020-04-06;38;417;1;11
Sul;SC;2020-04-07;40;457;4;15
Sul;SC;2020-04-08;44;501;2;17
Sul;SC;2020-04-09;192;693;1;18
Sul;SC;2020-04-10;24;717;0;18
Sul;SC;2020-04-11;15;732;3;21
Sul;SC;2020-04-12;44;776;3;24
Sul;SC;2020-04-13;50;826;2;26
Sul;SC;2020-04-14;27;853;2;28
Sul;SC;2020-04-15;31;884;1;29
Sul;SC;2020-04-16;42;926;1;30
Sul;SC;2020-04-17;36;962;1;31
Sul;SC;2020-04-18;13;975;1;32
Sul;SC;2020-04-19;50;1025;3;35
Sul;SC;2020-04-20;38;1063;0;35
Sul;SC;2020-04-21;28;1091;2;37
Sul;SC;2020-04-22;24;1115;2;39
Sul;SC;2020-04-23;55;1170;3;42
Sul;SC;2020-04-24;39;1209;0;42
Sul;SC;2020-04-25;26;1235;0;42
Sul;SC;2020-04-26;102;1337;1;43
Sul;SC;2020-04-27;139;1476;1;44
Sul;SC;2020-04-28;519;1995;0;44
Sul;SC;2020-04-29;90;2085;2;46
Sul;SC;2020-04-30;309;2394;2;48
Sul;SC;2020-05-01;-290;2104;2;50
Sul;SC;2020-05-02;242;2346;2;52
Sul;SC;2020-05-03;173;2519;0;52
Sul;SC;2020-05-04;104;2623;3;55
Sul;SC;2020-05-05;172;2795;3;58
Sul;SC;2020-05-06;122;2917;1;59
Sul;SC;2020-05-07;165;3082;4;63
Sul;SC;2020-05-08;123;3205;0;63
Sul;SC;2020-05-09;167;3372;1;64
Sul;SC;2020-05-10;57;3429;1;65
Sul;SC;2020-05-11;100;3529;4;69
Sul;SC;2020-05-12;204;3733;4;73
Sul;SC;2020-05-13;95;3828;0;73
Sul;SC;2020-05-14;504;4332;5;78
Sul;SC;2020-05-15;230;4562;1;79
Sul;SC;2020-05-16;116;4678;2;81
Sul;SC;2020-05-17;98;4776;2;83
Sul;SC;2020-05-18;399;5175;2;85
Sul;SC;2020-05-19;238;5413;6;91
Sul;SC;2020-05-20;86;5499;3;94
Sul;SC;2020-05-21;111;5610;4;98
Sul;SC;2020-05-22;848;6458;2;100
Sul;SC;2020-05-23;149;6607;3;103
Sul;SC;2020-05-24;89;6696;2;105
Sul;SC;2020-05-25;179;6875;4;109
Sul;SC;2020-05-26;141;7016;12;121
Sul;SC;2020-05-27;356;7372;5;126
Sul;SC;2020-05-28;628;8000;5;131
Sul;SC;2020-05-29;530;8530;3;134
Sul;SC;2020-05-30;250;8780;2;136
Sul;SC;2020-05-31;257;9037;7;143
Sul;SC;2020-06-01;461;9498;3;146
Sul;SC;2020-06-02;162;9660;2;148
Sul;SC;2020-06-03;374;10034;4;152
Sul;SC;2020-06-04;498;10532;4;156
Sul;SC;2020-06-05;314;10846;3;159
Sul;SC;2020-06-06;439;11285;7;166
Sul;SC;2020-06-07;280;11565;5;171
